1.50元	個半
5分錢	斗令
Eng	英靈
OK繃	藥水膠布
T字衫	T恤	笠記	過頭笠
T恤	笠記	過頭笠
T恤衫	T恤	笠記	過頭笠
template	番薯
…不完	…唔晒
…也是白搭	…都假啦
…也是白費勁	…都假啦
…人	佬
…個正著	…到正
…到了	…到
…到極點	…到飛起
…十多歲	…張幾
…嘛	[嗝]
…多一點兒	…鬆啲
…多了	多多聲
…多少錢？	…點賣？	啲…點賣呀？
…好	掂
…子	佬
…就…	食…送…
…得	…到
…得夠戧	…得交關
…得很厲害	…得交關
…得正是時候	…到正
…得要命	…到死	…到飛起	…到鬼噉	…得交關
…得要死	…到死
…才怪	…至奇
…極了	…到極	…到死	夠晒…
…死了	…到死
…的樣子	…噉	…噉嘅款	…噉頭
…破	…親
…而已呀	咋
…著	…到	…緊
…要命	鬼死咁…
…起	起首
…路	…號
…都不行	…都唔得
〜點整	沓正〜點
一…	…親	…親就…	…親都…
一…就…	…親	…親就…	…親都…
一丁點	啲咁多
一丁點兒	丁咁多
一下	吓
一下兒	一次過
一下子	一吓	一吓間	一時三刻	霎時	霎時間
一不做二不休	做戲做全套
一不幹活就沒飯吃了	手停口停
一串串的	一揪一掕
一事無成	食白果
一些	些少	啲	多少
一個人	一丁友	一支公
一個人全包了	一腳踢
一個人影都沒有	鬼影都冇隻
一個勁	起勢
一個勁兒	一味
一個勁兒地	一味	起勢	起勢噉
一個勁地	起勢	起勢噉
一個唱白臉	一個做好，一個做醜
一個唱紅臉	一個做好，一個做醜
一個地方	一度
一個子兒	一個崩
一個對一個	隻抽
一個時候一個時候	一時時
一個樣兒	一個餅印
一個而已	一個啫
一倒霉就處處倒霉	衰起上嚟有頭有路
一元	一蚊雞	一雞
一元多	個幾	蚊幾
一元多一點點	個零銀錢	蚊零
一元多差不多二元	蚊幾兩蚊
一刀兩斷	一拍兩散	斬纜
一分錢	一個崩
一切都弄妥當了	攪掂晒
一切都辦好了	攪掂晒
一刻	骨
一副…模樣	成個…噉嘅款
一副小白臉	青靚白淨
一副鬼相	貓樣
一力承擔	一腳踢
一動一動	喐吓喐吓	喐喐吓
一動不動	成嚿佛	成尊佛噉
一動也不動	喐都唔喐
一包一袋	一揪一掕
一口	啖
一口承擔	拍心口
一口氣	一條氣
一句話	一句到尾
一句話不說	粒聲唔出
一句話也不說	粒聲都唔出
一句話都不說	一句話都唔聲
一向	一路	不溜
一回兒	一陣
一團亂	一鑊泡
一團糟	一鑊泡	烏喱單刀
一場空	得個吉
一塊半	個半
一塊多一點點	個零銀錢	蚊零
一塊多錢	個幾	蚊幾
一塊錢	一蚊雞	一雞
一塌糊塗	一鑊泡	烏喱單刀	雞毛鴨血
一天	一日
一天到晚	一日到黑
一學便會	一學就識
一定	一實	奉旨	實	實係	實牙實齒	實穩	實行	是必	梗	硬係
一定…	[嗝]
一定不	奉旨唔
一定來	實嚟
一定去	實穩去
一定弄妥當	包攪掂
一定成	實得
一定成的	實得㗎喇
一定投訴你	告到你甩褲
一定會	實會
一定沒錯	實穩冇錯
一定要	一於
一家	一頭家
一家一家	逐家逐戶
一家一家地	逐家逐戶噉
一家大小	一家仔乸
一家老小	一家仔乸
一寒如此	窮到燶
一對一	單對單
一對兩對	一啤兩啤
一對對	一啤啤
一心一意	疊埋心水
一戳就破	一拮就穿	一督就穿
一手包辦	一腳踢
一手抓著	一手揸住
一把汗	一額汗
一擊入洞	一桿入洞
一整個小時	成個鐘
一文不值	一戙都冇
一文不名	拍手無塵	窮到燶
一是	一係
一是…一是…	一係…一係…
一時	一時三刻
一時一時的	一時時
一時糊塗	鬼揞眼
一會	陣間
一會兒	一陣間	轉頭	陣	陣間
一會兒之後	聽暇
一會兒見	一陣見
一會再說吧	陣間先講
一朝被蛇咬	見過鬼就怕黑	見過鬼怕黑	見過鬼都怕黑
一杯茶加兩個點心	一盅兩件
一杯茶和兩三樣茶點	一盅兩件
一桿進洞	一桿入洞
一模一樣	一個餅印	一擔擔
一樣	一式
一樣的	一擔擔
一樣貨色	一擔擔
一次	一鑊
一次性	一次過
一次為止	一次過
一步	層
一步一步做著看	行一步睇一步
一步跨過去	大步諵過
一段時間	排	陣
一氣	一條氣
一流的	勁
一炮兌雙象	一炮搏雙象
一点	層
一点点	啲啲咁多
一無所得	得個吉
一無所有	窮到燶
一物降一物	生魚治塘蝨
一生	成世
一番	一鑊
一瘸一拐	趷吓趷吓
一盤	一鋪
一直	一路	不溜	直頭
一直以為	一路以為
一直到	落到去
一直吃	食開
一直服用	食開
一直走	一直去	一直行
一直都有	一路都有
一眨眼	䁪吓眼
一眨眼就…	䁪吓眼就…
一眼看上去	驟眼睇
一瞬間	䁪吓眼
一知半解	識啲唔識啲
一竅不通	盟塞
一竹竿打了一船人	一竹篙揇咗一船人
一聲不吭	粒聲唔出	粒聲都唔出
一聲不響	粒聲唔出	粒聲都唔出
一肚子氣	一泡氣
一肚子鬼主意	一肚屎計
一股勁	一條氣
一股勁兒地幹	起勢噉做
一腳跨過去	諵過
一般	不過不失	伊拉七	伊撈七	通拉	麻麻
一般來說	一般嚟講	伊拉七	伊撈七
一般情況下	伊拉七	伊撈七
一般產品	行貨
一般的	一般嘅
一般般	不過不失	麻麻	麻麻哋
一萬多塊	萬幾蚊
一處	一度
一言不發	粒聲唔出
一言以蔽之	一句講晒
一說就明白	話頭醒尾
一諾千金	牙齒當金使
一貧如洗	拍手無塵	窮到燶
一貫	一路
一起	一齊	兩份	齊齊
一起地	兩份
一起混	同撈同煲	同煲同撈
一路平安	順風順水
一路順風	順風順水
一身整齊	身光頸靚
一身麻烦	一身蟻
一車兌雙馬	一車搏雙馬
一輩子	一世	一世人	一生人	成世	永世
一輩子時間長	一世流流長
一輩子漫長的歲月	一世流流長
一輩子都忘不了	永世都記得
一輩子長著呢	一世流流長
一轉眼	轉吓眼
一遇著	逢親
一邊	一便	一頭	側便	側邊
一邊…	一便…，一便…
一邊…一邊…	一住…一住…	一路…一路…
一邊兒	一頭	側便	側邊
一邊兒…一邊兒…	一頭…一頭…
一錢不值	一戙都冇
一鍋端	一鑊熟
一長一短的筷子	鴛鴦筷
一開始	初頭
一陣子	一陣	陣
一隻一個樣兒的鞋	鴛鴦鞋
一隻眼	單眼
一雙左右配不上的鞋	鴛鴦鞋
一頭	一便
一點	一啲	啲
一點也不	一啲都唔
一點也不知道	一啲都唔知
一點也沒有	冇厘
一點兒	些少	多少
一點兒也不沾邊	唔挐耕
一點兒沒錯	啱到極
一點兒辦法也沒有	冇晒符
一點力氣也沒有	週身冇力
一點希望也沒有了	冇晒聲氣
一點東西	少少嘢
一點輒也沒有	冇晒收
一點轍兒都沒有	冇晒符
一點辦法都沒有	冇晒收
一點都不奇怪	一啲都唔奇
一點都沒有	冇厘
一點點	些少	啲咁多	少少
一點點而已	少少咋
一鼻子灰	一面屁
一鼻孔出氣	一擔擔
一齊動手	合手合脚
丁	積	粒
丁丁糖	啄啄糖
丁兒	粒
七上八下	十五十六
七八成	七七八八
七十多歲	七張幾
七夕	七姐誕
丈人	外父
丈夫	先生	老公	蝦子餅
丈夫的三哥	三少
丈夫的三弟	三少
丈夫的二哥	二少
丈夫的二弟	二少
丈夫的兄弟	少
丈夫的大哥	大少
丈夫的姑母	姑太
丈母娘	外母	外母乸
三八	八卦婆	八婆
三十	卅
三十一	卅一
三十七	卅七
三十三	卅三
三十九	卅九
三十二	卅二
三十五	卅五
三十五分鍾	七個字
三十來塊錢	卅幾蚊
三十八	卅八
三十六	卅六
三十分鍾	六個字
三十四	卅四
三十多歲	三張幾
三十年河東	風水輪流轉
三十年河西	風水輪流轉
三十晚上走夜路	煲冇米粥，水汪汪
三十歲	卅歲人
三塊錢	三蚊雞
三心二意	心多多
三心兩意	心多多	花心
三思	睇定啲
三明治	三文治
三步並作兩步走	三步擸埋兩步走
三歲定終身	三歲定八十
三歲看老	三歲定八十
三級片	三仔
三缺一	爭隻腳
三葷一素	一齋三雜
三角架	腳架
三長兩短	冬瓜豆腐
上下	上落
上下彈動	䟴	岌
上下跳動	岌岌貢
上下颌前突	哨牙
上中學	讀中學
上了年紀的婦人	老藕
上個星期	上個禮拜
上前來	埋嚟
上午	上晝	朝頭早
上司	波士	老頂	頭
上吊	吊頸
上吐下瀉	又屙又嘔
上坡	上斜
上墳	拜山
上夜班	開夜
上大學	入大學	讀大學
上大學唸書	入大學讀書
上好的	勁
上學	翻學
上小學	讀小學
上層人物	大粒佬
上山下山	爬上爬落
上床睡	上床瞓
上廁所	去廁所
上弦	上鏈
上映	上畫
上桐油	油桐油
上樓梯	行樓梯
上樹	擒樹
上次	上勻
上氣不接下氣	氣羅氣喘
上油	油
上漆	油
上火	熱氣
上焦熱	熱氣
上班	打工	翻工
上班值勤	出更
上班去做工	開工
上班族	打工仔
上當	中招	領嘢	領當
上當了	領嘢
上當受騙	賣豬仔
上發條	上鏈
上白班	當日更
上相	上鏡
上眼皮	眼簷
上碟	起鑊
上等的	好正
上等貨	靚嘢
上算	化算
上級	上頭	老細
上級知道了	通天	通晒天
上級領導	高層
上臂	手瓜	手骨
上船	落船
上茅廁大便	踎坑
上茶樓	歎茶
上菜	起菜
上蠟	打蠟
上街	出街	去街	落街
上街買東西	出街買嘢
上街買菜	去街買餸
上街走走	落街行吓
上課	上堂	聽書
上電視	上鏡	出鏡
上面	上便	上頭
上香	裝香
上馬	去馬
下	落
下一站請停車	有慢	有站慢	有落
下一輩子	第世
下不了手	唔落得手
下不為例	一次過
下令	落令
下作的勾當	衰嘢
下來	落嚟
下個星期	下個禮拜	第個禮拜
下個月	第個月
下冰雹	落雪珠
下功夫	畀心機
下午	下晝	晏晝
下半生	下半世
下半輩子	下半世
下去	落去
下台	落台
下台階	落石級
下回	第時
下坡	落斜
下夠	落足
下大雨	落大雨	落狗屎
下定單	落單
下定決心	立定心水	立實心腸
下定金	落定
下山	落山
下巴	下扒
下巴頦	下扒
下巴頦兒	下扒
下很冷的小雨	落雪水
下手	埋手	落手
下本錢	落本
下棋	捉棋
下棋比賽	捉棋比賽
下樓	落樓
下樓梯	落樓梯
下次	第時	第次
下次吧	不如下次先啦
下毒	落毒
下毒藥	落藥
下毛毛雨	落雨溦	雨溦溦
下水	雜
下水道	坑渠
下水道不通	塞坑渠
下注	落注
下流	鹹濕
下流的	不文
下流的動作	不文動作
下流的女人	衰婆
下流話	爛口	粗口
下流鬼	衰公
下班	收工	收更	放工	落更	落班
下眼皮	眼肚
下腳貨	籮底橙
下藥	落藥
下蛋	生蛋
下襬	衫腳
下課	落堂
下賤	賤格
下賭注	落注
下起雨來	落起雨嚟
下足	落足
下足了工夫	落足功夫
下足功夫	落足功夫	落足心機
下跳棋	捉波子棋
下車	落車
下輩子	下世	第世
下邊	下便
下鄉	落鄉
下雨	落雨
下雨路滑	落雨濕濕	落雨絲濕
下雪	落雪
下雹子	落雪珠
下面	下低	下便	下底
下頜骨關節脫臼	甩牙骹
下頭	下底
下頷骨關節	牙骹
下飛機	落機	落飛機
下館子	飲茶
下馬	落馬
不	唔
不…不行	想唔…都幾難
不…才怪呢	唔…就假	唔…就假嘅	唔…就有鬼
不…那就很奇怪	唔…就有鬼囉
不一定	兩睇	唔一定
不一樣	唔同
不三不四	林林沈沈	林沈
不三不四的事	林沈嘢
不三不四的朋友	損友
不上算	唔化算
不中用	唔中用	死僆仔
不中用的人	跛腳鴨
不久	冇幾耐	冇耐	唔使一陣	唔耐
不乾不淨	大菌食細菌
不乾淨	揦鮓	邋遢
不乾淨的東西	污糟嘢
不介意	唔計帶
不但	不特	唔單止	唔在講	唔止
不但…還…	唔止…仲…	唔止…仲…添
不但如此	唔單止噉
不佔地方	慳位	慳地方
不使人知道	揞密鑼鼓
不修邊幅	咧啡
不倫不類	唔三唔四
不倫不類的人	騎呢𧊅
不值	唔抵
不值得	唔值得	唔抵
不值得去想	冇得諗
不值得幫忙	唔抵幫
不值錢	爛賤
不做壞事的人	好人好姐
不停地	一條氣	生晒	起勢噉
不停地想著	心思思
不停地搖頭	頭擰擰
不停地瞎鬧	攪攪震
不停地顫動	揗揗震
不停抖腿	䟴身䟴勢
不僅	不單止	不特	不特止
不僅如此	唔單止噉
不像	唔似
不像樣	唔似樣	失禮
不像樣子	失禮晒
不像樣子﹐有失禮貌﹐禮數不周	失禮
不像話	冇解	冇譜	唔似樣
不光	不特
不光彩的手段	橫手
不光是	唔止
不光是…	唔關事
不光滑	嚡
不入時	老土
不公平	唔公平	大細超
不公平對待	大細超
不再	唔再
不再幹	收山
不准	唔准
不分老幼尊卑	冇大冇細
不切實際的	唔等使
不划算	唔制得過	唔化算	唔抵
不利索	論盡
不到外頭去	屈喺屋企
不到時候不著急	煮到埋嚟先食
不加	走
不加冰	走冰
不加奶	飛沙走奶
不加糖	走糖	飛沙走奶
不加肉	走肉
不加蔥	走青
不加蛋	走蛋
不加雞蛋	走蛋
不動	唔喐
不動產	物業
不及格	肥	肥佬
不只	不單止	不特止
不可一世	招積
不可以	唔可以
不可小看	嘢少
不可挽回	冇得擝	冇得玩
不可收拾	唔得掂	雞毛鴨血
不可能	冇可能	唔可能
不可靠	兒嬉
不可靠的消息	流料
不吃葷	唔食雜
不合心意	唔合眼緣	唔啱心水
不合時宜	老土
不合格	肥	肥佬
不合法	唔合法
不合理	唔合理	無厘頭
不合用	唔啱用
不合穿	唔啱著
不合算	冇數為	唔化算	唔抵	蝕底	輸蝕
不合群	古縮
不合適	唔合適	唔啱用
不合邏輯	無厘頭
不吉利	唔好意頭	邪
不同	唔同
不同意	唔同意
不同的時候	一時時
不含糊	君真
不吭聲	唔出聲
不問自取	滾
不善解人意	話頭唔醒尾
不善言辭	口湆
不喜歡	唔鍾意
不喜答話	十問九唔應
不單	不單止	不特止
不單是	不單止	不特止
不嚴肅	伊挹
不土不洋	半唐番
不在	唔响度	唔喺度
不在乎	唔志在
不在家	出門	出門口	唔喺屋企
不在意	唔計帶
不在話下	唔在講
不在這裡	唔响度
不在那裡	唔响度
不堪一擊的人	魚腩
不多	唔多
不夠	唔夠	唔夠喉	唔夠皮	未夠
不夠塞牙縫兒	唔夠攝牙罅
不夠塞牙縫的	唔夠攝牙罅
不夠朋友	唔夠老友	絕情
不夠本	唔夠皮
不夠格	唔夠quali
不夠爽快	湆手湆腳
不夠花	唔夠使
不夠資格	未夠班
不夠錢用	手緊	水緊
不大…	唔係幾
不大像	唔係幾似
不大可能	冇乜可能
不大合得來	唔係好合
不大好	不過不失	麻麻
不大方	思縮
不太	乜滯
不太…	唔係幾
不好	唔好	唔盞
不好了	大件事	弊傢伙
不好使用	擇使
不好吃	唔好食	湆口
不好喝	唔好飲
不好對付	惡作
不好幹	惡做
不好弄	惡攪
不好意思	唔好意思
不好找	難搵
不好看	唔好睇
不好答應	唔好制
不好聽	唔好聽
不好說話的	惡撠
不好辦	唔易做	攪唔掂	濕滯
不如	不宜
不如人	低威
不如這樣	不如噉
不妥	唔掂
不妥當	唔妥
不妨	冇壞
不妨礙你	唔阻你
不妨礙各位	唔阻咁多位
不守秘密	口疏
不安全	唔安全
不定時地	不時
不客氣	乜說話	唔使	唔使客氣	應該嘅
不害羞	唔怕醜
不容易	唔容易
不實在	兒嬉	半天吊
不實際	唔實際
不專心	冇心機	水過鴨背
不對	唔啱	唔著
不對勁	唔妥	唔對路
不對勁兒	唔係路
不對稱	大細超	鴛鴦
不對稱的兩扇門	鴛鴦門
不對頭	唔係路	唔妥	唔對路
不小心	唔小心	唔覺意	論盡
不少	唔少
不就是	咪係	咪就係
不平整	岩巉
不幹	咪攪	唔做	唔制
不幹了	唔撈	擗炮
不得了	唔得掂
不得好死	冇乜好死
不必	無謂
不必在乎的	閒閒哋
不必找錢了	唔使找
不必要地表現出慷慨	讕大方
不必說了	唔使講
不忍看	冇眼睇
不忿	唔抵
不怎麼	乜滯	冇乜
不怎麼…	唔係幾
不怎麼像	唔係幾似
不怎麼合人的意	唔啱心水
不怎麼好看	冇乜好睇
不怎麼樣	不過不失	麻麻	麻麻啫
不怕	唔怕
不怕吃虧	抵得諗	抵諗
不怕委屈	抵得諗	抵諗
不怕死	唔錫身
不想	冇心	唔想
不想吃	湆口
不想工作	搏炒
不想看	冇眼睇
不想管	冇眼睇
不想聽	冇耳聽
不愁	唔憂
不愁吃	唔憂食，唔憂著
不愁穿	唔憂食，唔憂著
不愛多說話	口密	密實
不愛搭理人	十問九唔應
不愛說話	口密	密實
不感興趣	心淡	睇淡
不感興趣了	睇淡晒
不慌不忙	好定當	定當
不懂	唔明
不懂事	唔熟性	唔生性	未生埋腦筍	腦筍未生埋
不懂人情世故	唔熟性	唔識做
不懂得事情危急	唔知死	唔識死
不懂得利害	未知死
不懂得利害關係	未識死
不懂禮貌	冇家教
不懂規矩	唔熟性
不應該	唔應該
不成	唔掂
不成器	爛泥扶唔上壁
不成對兒	鴛鴦
不成敬意	失禮	失禮晒
不成材	爛泥扶唔上壁
不扎實	兒嬉
不打擾了	唔阻你
不打擾各位	唔阻咁多位
不投機	水溝油
不收拾好	冇手尾
不放在眼裡	當佢冇到
不放心	唔安樂	心掛掛
不放過	通殺
不故意	冇心
不敢	唔敢
不敢當	點係
不敢發言	企埋一邊
不敢相信	打死唔信
不敢說出來	講唔出口
不敬	串
不料	點知
不斤斤計較	抵得諗	抵諗
不斷地	生晒
不方便	唔方便	論盡
不明事理	咁盟塞	盟塞
不明所以	一嚿雲
不明理	懵
不明白	唔識解
不明真相	懵閉閉
不易做完	禁做
不易死	禁死
不易變色	禁色
不是	唔係
不是一對的	鴛鴦
不是一對的襪子	鴛鴦襪
不是什麼好人	好人有限
不是吧	唔係啩
不是因為…	唔關事
不是對手	唔係手腳
不是才好	至好唔係
不是才怪	至好唔係
不是省油的燈	唔係嘢少
不是這麼說	唔係噉話
不時	久不久
不時興	唔興
不時髦	老土
不會	唔會	唔識
不會做	唔識做
不會做人	唔熟性
不會吃虧	唔會輸蝕
不會吧	唔會啩	有冇攪錯
不會吧？	唔係呀話
不會唱歌	唔識唱歌
不會察言觀色	話頭唔醒尾
不會幹	唔識做
不會拐彎	唔識轉彎
不會的	唔會嘅
不服氣	唔忿	唔忿氣	唔抵得	條氣唔順
不服老	唔忿老
不服輸	唔衰得	死剩把口
不標準	唔鹹唔淡
不機靈	話頭唔醒尾
不歡而散	一拍兩散
不止	不單止	不特止
不正常	唔正常	神	神神地	邪
不正派	伊挹	唔三唔四	邪	鬼馬
不正當地謀利	抽水	食水
不正確	唔著
不正經	唔三唔四	喪	大癲大廢	邪	鬼五馬六	鬼馬
不正規	伊挹
不比別人差	唔輸蝕
不沾邊	冇挐耕
不流行	唔興
不消化	反胃
不消說	唔在講
不清不楚	鬼食泥
不清楚	唔清楚
不測	冬瓜豆腐
不滿	亞吱亞咗
不滿足	唔夠喉
不為別的	無他
不然的話	唔係嘅話
不熟的	生勾勾
不熟練	唔熟行
不爭氣	爛泥扶唔上壁
不牢	兒嬉	唔穩
不牢固	兒嬉
不牢靠	半天吊
不理	唔理	唔騷
不理不睬	闊佬懒理	闊佬懶理
不理他	唔睬佢
不理他的	唔聽佢笛
不理你	睬你都傻
不理你了	理你咁多
不理你啦！	費鬼事睬你
不理睬	唔騷
不理睬你	睬你都傻
不甘心	唔抵
不用	使乜	唔使
不用了	唔好啦
不用客氣	使乜咁客氣	唔使客氣
不用工作了	唔使做
不用怕	冇有怕
不用想	冇得諗
不用找	唔使找
不用提	唔使講
不用擔心	唔使憂
不用擔憂	唔使憂
不用管	唔使知
不用管他	睬佢都傻
不用計較	冇計
不用說	使乜講	唔使講	唔在講
不用送了	唔使送呀
不用道歉	使乜道歉
不用那麼謙虛啦	唔使咁謙噃
不由得你不…	唔到你唔…
不由得信服	寫個服字
不留情面	唔畀面
不留神	唔覺意
不痛快	心翳
不盡力	錫身
不相上下	一擔擔
不相信	唔信	唔相信
不相干	冇挐耕	冇挐褦	冇相干	唔關事	牛頭唔搭馬嘴
不真實的資料	流料
不睬你了	理你咁多
不知不覺	唔經唔覺
不知天高地厚	唔知死	唔識死
不知好歹	唔知好醜	唔識衰
不知如何是好	心大心細
不知所云	一嚿雲
不知所以	無厘頭
不知所措	慌晒
不知所謂	無厘頭
不知趣	唔通氣
不知道	唔知	唔知道
不知道利害	唔知死	唔識死
不知道為什麼	唔知點解
不知道該怎樣做	心大心細
不硬	腍
不確切的消息	流料
不確切的訊息	流料
不祥	邪
不禮貌	串
不穩	唔穩
不穩固	岌岌貢
不穩定	岌岌貢
不穿襪子	唔著襪
不符合樣品	唔對辦
不等了	等唔切
不算好	不過不失	麻麻
不管	冇眼睇	唔理	唔論	懶理
不管三七二十一	有理冇理
不管他	當佢冇到
不管它	有理冇理
不管怎樣	話晒	點都好
不管怎麼樣	有理冇理
不管有理沒有理	有理冇理
不管用	唔中用
不管那麼多	有理冇理
不節制地用錢	洗腳唔抹腳
不簡單	唔係嘢少
不精明的人	大番薯
不結實	兒嬉	削	化學	唔禁
不給他一點面子	當佢冇到
不給面子	唔畀面
不經常	耐中	耐唔中	耐耐
不經打	唔禁打
不緊不慢	唔嗲唔吊
不習慣	唔慣	唔習慣
不耐久	唔禁
不耐煩	唔耐煩
不耐用	化學	唔禁
不耐穿	唔禁著
不耽誤你的時間	唔阻你
不聞不問	費事理	闊佬懒理	闊佬懶理
不聽人勸	自把自為
不聽他使喚	唔聽佢支死人笛	唔聽佢支笛	唔聽佢笛
不聽他吩咐	唔聽佢支死人笛	唔聽佢笛
不聽他發號施令	唔聽佢支死人笛
不聽他的	唔聽佢支笛	唔聽佢笛
不聽他那一套	唔聽佢支笛	唔聽佢笛
不聽他那套	唔聽佢支笛	唔聽佢笛
不聽你使喚	唔聽你支笛	唔聽你笛
不聽你的	唔聽你支笛	唔聽你笛
不聽你那一套	唔聽你支笛	唔聽你笛
不聽你那套	唔聽你支笛	唔聽你笛
不聽我使喚	唔聽我支笛	唔聽我笛
不聽我的	唔聽我支笛	唔聽我笛
不聽我那一套	唔聽我支笛	唔聽我笛
不聽我那套	唔聽我支笛	唔聽我笛
不聽管教	冇王管
不聽話	刁僑扭擰	奀皮	扭紋	扭計	曳
不肯幫忙	托手踭
不能	唔能
不能一下子做好的	禁攪
不能來	唔嚟得
不能動	唔喐得
不能去	唔去得
不能吃	唔食得
不能善始善終	爛尾
不能容忍	睇唔入眼	睇唔過眼
不能得罪	唔得罪得
不能接受	接受唔到
不能控制	控制唔到
不能由你	唔到你
不能相比	蚊髀共牛髀	蚊髀同牛髀
不能解釋	唔識解
不能走	唔走得
不能這麼說	唔係噉話
不自量力	讕叻	讕架勢
不至於	唔至於
不舊	新淨
不舒服	唔妥	唔聚財	唔舒服	囉攣	頭暈身㷫	頭暈身熱
不良少年	串仔
不苟言笑	苦瓜乾噉口面	苦瓜噉口面	苦瓜噉嘅面	苦瓜噉面	苦瓜面
不著邊際	唔挐耕
不行	低威	唔中用	唔得	唔掂
不行就回老家	得就得，唔得就翻順德
不褪色	禁色
不要	咪	唔好	唔要
不要介意	唔好計帶
不要作聲	唔好出聲
不要信口開河	係你先至好講呀
不要再打這個主意了	咪指擬
不要冰	走冰
不要加冰塊	走冰	走雪
不要動	唔好喐
不要命	搏死	狼胎
不要命的	狼死
不要客氣	唔好客氣
不要幹	唔好制
不要怕	冇有怕	唔使慌	唔使驚
不要慌張	定啲嚟
不要拉下	攞齊啲嘢	攞齊嘢
不要焦急	唔好心急
不要煩我	咪攪我
不要答應	唔好制
不要算我	唔好預我
不要緊	冇相干	冇緊要	唔緊要
不要說	咪話	唔好話
不要走啦	咪走呀
不要隨便許諾	冇咁大個頭唔好戴咁大頂帽
不見了	唔見咗
不見得	未必
不見棺材不落淚	唔見棺材唔流眼淚
不見蹤影	人間蒸發
不覺得	唔覺
不覺醒	唔化
不言不語	木木獨獨
不計較	唔計帶	抵得諗	抵諗
不計較利益	抵得諗	抵諗
不記得	唔記得
不認前賬	反口覆舌
不認失敗	跌低揦翻拃沙	跌落地都要揦翻拃沙
不認帳	唔認數
不認得路	唔識路
不認真	求求其其
不認識	唔識
不認識他	唔識佢
不認識路	唔識路
不認賬	奸貓	奸賴	賴貓
不說話	唔聲
不論	唔論
不論怎麼說	話晒
不講理	冇厘搭霎	冇搭霎	冇紋冇路
不講衛生的人	污糟貓
不謝	唔使唔該
不識好歹	牛噍牡丹
不識字	唔識字
不識相	唔識做
不識趣	唔通氣
不負責任	冇搭霎	甩底
不費勁的工作	懶佬工夫
不費工夫的工作	懶佬工夫
不賞臉	唔畀面
不足夠	唔夠皮
不跟你廢話	冇你咁好氣	冇咁好氣
不跟你說	冇咁好氣
不踏實	冇搭霎
不近	唔近
不通的	盟
不過	之不過	之但係
不過問	冇眼睇
不過癮	唔夠喉
不道德	唔道德
不適合看	唔啱睇
不遵管教	冇王管
不重要	唔緊要	唔重要
不錯	唔錯	幾好
不鏽鋼勞力士錶	鋼撈
不開工就沒有工資	手停口停
不開心	唔開心
不開朗	古縮
不開竅	咁盟塞
不開胃	湆口
不開通	唔化	盟塞
不離開	傍
不難	唔難
不難看	睇得過
不需要	唔使	唔需要
不靈活	一嚿飯噉	唔識轉彎	執滯	戾偈	死估估
不靈通	背
不靠譜	隔山買牛
不頂用	唔中用
不頂用的	唔等使
不順利	唔掂	戾偈	濕滯	阻滯
不順口	繑口	繑脷
不順眼	唔聚財	唔開胃
不順耳	哽耳
不順路	唔啱路
不領情	好心著雷劈
不願干預	冇眼睇
不願意	唔制
不願看	冇眼睇
不願聽	冇耳聽
不馴服	扭計	牛精
不體面	耷濕
不高興	唔高興
不鳴則已一鳴驚人	唔聲唔聲，嚇你一驚
且不說	唔好話	姑勿論
且慢	咪住	慢住
世界上的事	有乜咁出奇
世面	大蛇屙尿
丘吉爾	邱吉爾
丘陵	山仔
丟	掉	跌
丟下	丟低	掉低
丟下來	丟低
丟了	失咗	擗咗	跌咗
丟人	丟架	失禮
丟人現眼	衰俾人睇	醜死鬼
丟失	賴	跌咗	跌失
丟掉	抌	擗
丟掉了	抌咗
丟棄	掉	擗	擗咗
丟臉	丟架	剃眼眉	失禮	甩鬚	瘀	羞家	落臉	落面
丟面子	丟架	瘀
並且	兼夾
丫頭	女包
丫鬟	妹	妹仔
中了招	揩嘢
中了邪	中咗邪
中午	晏晝
中國	唐	唐山
中國人	唐人
中國城	華埠
中國的	唐
中國菜	唐餐
中國雨蛙	騎呢𧊅
中大衣	中褸
中學生	中學雞
中客車	小巴
中客車司機	小巴司機
中小型企業	中小企
中巴	van	van仔
中式服裝	唐裝
中式樓房	唐樓
中式糕點	唐餅
中式菜餚	唐餐
中式衣服	唐裝	唐裝衫
中式飯菜	唐餐
中式餐廳	唐餐樓
中式點心	唐餅
中文課	中文堂
中暑	焗親
中班	中更
中看不中用	唔打得都睇得
中秋節	八月十五
中空的	通心
中聽	啱聽
中藥店	藥材舖
中藥舖	藥材舖
中裝	唐裝
中計	中招
中醫骨傷科	跌打
中間不通	盟籠
中間人	艇仔
中風	爆血管
中餐	唐餐
中餐館	唐餐樓
串	掕	揪	纊掕
串通	合計	夾計	通水
串通作弊	通水
串通口供	夾口供
主事	話事
主事人	揸弗人
主人	事頭
主動親近	投懷送抱
主意	橋	計	計仔
主打歌	派台歌	派台歌曲
主管	老細	頭
主管錢財	揸數
主要原因在於	勝在
主辦人	攪手
主辦者	攪手
主顧	客仔
久	耐
久煮的好湯	老火靚湯
久煮的湯	老火湯
之間	介乎
乒乒乓乓	乒鈴𠾴唥
乒乓球	乒乓波
乒乓球拍	波板
乖	抵錫
乖女孩	乖乖女
乖巧	精乖	精乖乖
乖巧女孩	乖乖女
乖巧男孩	乖乖仔
乖男孩	乖乖仔
乘出租车	的
乘出租车去	的去
乘坐小型公共汽車	搭小巴
乘客電梯	客猎
乘機撈一把	搏亂
乘法表	乘數表
乘涼	唞涼
乘船	坐船
乘車	搭車
乘車遊覽	遊車河
乘錯車	搭錯車
乘電梯	搭猎
乙醯	乙酰
乙醯膽鹼	乙酰膽鹼
九九歌	九因歌
九九表	九因歌
九死一生	死過翻生
九毛九	九毫九
九毛九分	九毫九
乞丐	乞兒
乞丐討飯	踎街
乞求	乞
乞討	乞
也	亦	亦都	添	都
也可以	都得
也可以的	都得
也好	都好嘅
也就是	亦即係
也是	亦都係	都係
也行	都得
也許	或者
乳	[姩]
乳房	[姩]	奶	波	𢆡
乳溝	事業線	姩罅	波罅
乳罩	胸圍
乳酪	芝士
乳酪蛋糕	芝士蛋糕
乳頭	𢆡頭
乾兒子	乾仔	契仔
乾哥哥	契哥
乾噎	乾鯁
乾女兒	契女
乾奶酪	芝士
乾妹	契妹
乾娘	契媽
乾媽	契乸	契娘	契媽
乾巴巴	乾鯁鯁
乾杯	飲勝	飲勝佢	飲杯
乾海產	海味
乾海產店	海味舖
乾淨利索	乾手淨腳
乾淨利落	乾手淨腳
乾淨整齊	企理
乾炒牛肉米粉條	乾炒牛河
乾燥	糠
乾爸爸	契爺
乾爹	契爺
乾牡蠣肉	蠔豉
乾瘦	瘦蜢蜢
乾癟	瘦削
乾癬	牛皮癬
乾瞪眼	眼光光
乾瞪著眼睛	眼坦坦
乾脆	爽脆
乾脆利落	爽脆
乾菜	菜乾
乾著急	肉緊
乾蘑菇	冬菇
乾裂	爆坼
乾親的	契
乾貝	乾瑤柱	江瑤柱	瑤柱
乾酪	芝士
乾麵	撈麵
亂	亂晒坑	亂龍	立亂
亂七八糟	七國咁亂	亂晒坑	亂晒大龍	亂龍	啦啦亂	烏喱單刀	烏喱馬扠	立立亂	立立雜雜
亂了套	一鑊泡	亂晒坑	亂龍
亂來	亂咁嚟	亂嚟
亂動	亂喐	喐喐貢
亂吃東西	亂咁食嘢	亂食嘢
亂吹一氣	亂車廿四
亂塗	亂扠
亂想	亂諗
亂成一團	倒瀉籮蟹
亂成一團糟	七國咁亂
亂成一鍋粥	七國咁亂
亂打	[拂]
亂扔	亂咁掉
亂揮霍	洗腳唔抹腳
亂搞	滾紅滾綠
亂搞一氣	亞茂整餅，冇嗰樣整嗰樣
亂攀關係	認親認戚
亂猜	亂估	估估吓	斷估
亂碰亂躥	亂咁舂
亂糟糟	亂立立	啦啦亂	立立亂
亂罵人	亂咁鬧人
亂翻	亂抄	抄
亂花錢	亂揈	亂揈錢	荷包倒吊
亂衝亂撞	舂瘟雞
亂說	亂噏	噏
亂說話	亂噏嘢	口花花
亂講	砌
亂走	貢
亂跑	亂趯	貢
亂跳一通	生蝦噉跳
亂闖	亂咁舂	亂撞
了	個囉噃	咗	咯	喇	嘞	囉	囉噃
了不起	了不得	了得	大晒	巴閉	有寶	架勢	醒
了吧	啦嗎
了結	收科
予人方便	搭路
事件	單嘢
事兒	事幹
事情	事	事幹	畸士
事情來得很突然	打突	打突兀
事情傳開了	通天	通晒天
事情多多的	事情多羅羅
事情快到結束才出問題	衰收尾
事情搞大了	通天	通晒天
事情跟你無關	唔關你事
事情迫到頭上來	逼到埋身
事情進展很順利	掂過碌蔗
事情鬧僵了	硬晒舦
事情鬧大了	攪到咁大劑	攪到咁大鑊
事態嚴重	大劑
二十	廿
二十一	廿一
二十七	廿七
二十三	廿三
二十九	廿九
二十二	廿二
二十五	廿五
二十五分鍾	五個字
二十元	廿蚊
二十八	廿八
二十八歲	廿八歲
二十六	廿六
二十分鍾	四個字
二十四	廿四
二十塊	二十蚊	廿蚊
二十塊錢	廿蚊
二十多歲	廿幾歲
二房東	包租公	包租婆
二房東太太	包租婆
二手貨	二攤	二攤貨	夜冷	夜冷貨
二流子	爛仔
二百五	十三點
二頭肌	老鼠仔
互不理睬	面阻阻
互不相干	三九唔識七
互不相欠	冇拖冇欠
互不相識	三九唔識七
互不認識	三九唔識七	三唔識七
互相抵觸	摳唔埋
互相排斥	摳唔埋
互相比較	格價
互相配合	合手合脚
五分鍾	一個字	字
五十五分鍾	十一個字
五十分鍾	十個字
五十塊	五十蚊
五十多歲	五張幾
五大三粗	大隻騾騾	牛高馬大
五彩繽紛	七彩
五花肉	五花腩	間花腩
五金店	五金舖
五顏六色	七彩	花哩碌
五香粉	香料粉
五香花生	南乳花生
五香花生仁兒	南乳肉
井字棋	井字過三關	過三關
井字遊戲	井字過三關	過三關
些	啲
些許	些少
交	磅
交代	話低	話落
交叉著雙手	繑住手	繑起對手
交叉雙手	繑手
交友要分清好人壞人	識人要帶眼
交友要善於辨別好人壞人	識人要帶眼
交定錢	落定
交往	拍拖
交待	交低
交房租	交租
交手打架	搏手
交接班	交更
交朋友	識朋友
交款處	收銀處
交班	交更
交白卷	食白果
交空房子	交吉
交給	畀過
交通不便	撠腳
交通堵塞	打晒纈
交通違例告票	牛肉乾
交通阻塞	塞車
交錢	磅水
享受	梳芙	歎
享受人生	歎世界
享受空調	歎冷氣
享樂	梳芙
享清福	歎世界
享用咖啡	歎咖啡
享福	歎世界
京劇	京戲
亮	光
亮光光	閃閃炩
亮堂	光猛
亮堂堂	光巉巉	光棖棖
人云亦云	學人口水溦	跟人口水溦
人人	個個
人人憎恨	犯眾憎
人人皆知	係人都知
人人討厭	神台貓屎	神憎鬼厭	逢人憎
人以群分	人夾人緣
人們	啲人
人倒霉	人衰行路打倒褪
人力車	車仔
人口販子	豬仔客
人多而擁擠	爆棚
人孔	沙井	沙井口
人孔蓋	沙井蓋
人字梯	擘梯
人家	人哋
人家有的我也有	人有我有
人小鬼大	人細鬼大
人小點子多	人細鬼大
人就怕被人哀求	人怕噅，米怕篩
人山人海	人頭湧湧
人怕別人多次懇求	人怕噅，米怕篩
人情歸人情	數還數，路還路
人材	料
人民幣	人仔
人的笑聲	畸卡
人緣好	好人事
人聲嘈雜	墟冚
人聲鼎沸	含含聲
人行天橋	天橋	行人天橋
人行山路	行山徑
人行道	行人路
人質	肉票
人造冰	生雪
人高馬大	大隻騾騾	牛高馬大
什麼	乜	乜嘢	乜嘢嘢	乜鬼	咩	咩嘢
什麼也不管了	幾大就幾大	幾大就幾大，燒賣就燒賣
什麼也沒有	乜嘢都冇	空框框
什麼事	乜事	咩事
什麼事？	咩事呀？
什麼人	乜人	乜嘢人	乜誰	亞誰
什麼什麼	乜乜
什麼什麼地方	乜乜地方
什麼什麼的	乜乜物物
什麼來頭	乜水
什麼倒霉事都碰上了	頭頭碰著黑
什麼原因	乜因由
什麼情況？	乜嘢環境？	咩嘢環境呀？	咩環境呀？	咩環境？
什麼意思	咩意思
什麼意思？	噉點呀？
什麼才是…？	點先算…
什麼時候	乜嘢時間	乜時候	幾時
什麼東東	乜東東
什麼東西	乜嘢	乜東東	乜水	乜鬼嘢
什麼東西都有	乜都有
什麼用處也沒有	有乜用
什麼話	乜嘢話
什麼辦法也沒有	蛇都死
什麼都	乜都
什麼都不怕	咩都唔驚
什麼都不會	乜都唔會
什麼都不管	乜都唔理
什麼都不管了	一鋪翻唐山
什麼都會一點但沒有專長	周身刀冇張利
什麼都有	乜都有
什麼都沒有	乜嘢都冇	乜都冇
什麼都沒有了	乜都冇晒
什麼風把你吹來了？	乜咁錯蕩
什麼？	乜嘢話？
仇怨	過節
仇恨	仇口
仇隙	過節
今天	今日
今天很冷	今日好凍
今天早上	今朝
今天晚上	今晚黑
今生受到報應	前世唔修
今非昔比	今時唔同往日
介意	計帶
介於	介乎
介蒂	過節
仔細考慮	諗真
仔细一想	諗深一層
他	佢
他倆	佢兩個
他們	佢哋
他們兩個人	佢兩個
他們的	佢哋嘅
他們自己	佢哋自己
他們自己的	佢哋自己嘅
他媽的	丟那媽
他的	佢嘅
他的為人	佢份人	佢個人
他自己	佢自己
他自己的	佢自己嘅
他這人	佢份人
他這個人	佢份人
他這個傢伙	佢隻嘢
他那種人	佢份人
仗	恃
仗勢凌人	蝦蝦霸霸
仗勢欺人	蝦蝦霸霸
仗著	恃
付	磅
付出全部精神	瞓晒身落去
付款	找數
付款台	收銀處
付款處	收銀處
付賬	找數	過數
付錢	找數	畀錢	磅水
仙人凍	涼粉
仙草	涼粉草
代人付款不把錢付出	托水龍
代人收款不把錢交給原主	托水龍
令	令到
令人害怕	得人怕	得人驚
令人憎惡	乞人憎	得人憎
令人討厭	乞人憎	得人憎
令堂	伯母
令壽堂	伯母
令得	令到
令眾人憎惡	犯眾憎
以一本而圖萬利	刀仔鋸大樹
以他為榜樣	睇住佢頭
以假充真	頂包
以偏蓋全	一竹篙打晒一船人
以免	免至
以前	先時	往日	舊底	舊時
以及	與及
以小博大	刀仔鋸大樹
以後	第日	第時
以為	估	認住
以牙還牙	你做初一，我做十五
以皮蛋做餡的傳統小吃	皮蛋酥
以血還血	你做初一，我做十五
以足頓地	𨂽地
仰	𩓥
仰泳	背式
仰睡	打昂瞓	昂住瞓
仰著	打昂
仰著睡覺	昂住瞓
仰頭	𩓥頭
件	味
任人宰割	肉隨砧板上
任人擺佈	肉隨砧板上
任性而刁鑽	刁蠻
任意捏造	生安白造
任由	由	由得
任隨	隨得
份內該做的	應份
仿冒產品	水貨
仿金首飾	朱義盛	朱義盛貨
伏地挺身	掌上壓
伐木	斬柴
伐木者	斬柴佬
休息	唞	唞身	小息	歎
休息一下	充充電	唞吓
休息休息	充充電
休息片刻	小息
伙	班
伙伴	拍乸	拍檔
伙食外包	包伙食
伯伯	世伯	亞伯
伯母	伯娘
伯父	亞伯	伯伯	阿伯
估計	約莫	諗住	預
伴郎	戥穿石
伶俐	精乖	精乖乖
伶牙俐嘴	牙尖嘴利
伸懶腰	伸懶
伸手	攤大手	攤大手板
伸手要錢	攤大手	攤大手板
伸腿兒	伸直咗	伸直腳	兩腳一伸	瓜柴
伸腿兒了	瓜直
伸舌頭	撻脷
伺機	搵機會
似乎是	好似係
似傻非傻	面懵心精
似懂非懂	識啲唔識啲
似曾相識	熟口熟面
但是	不過	之不過	之但係	但係
佈置停當	佈置定當
位置	埞方	忽
低下	耷低
低下來	耷低
低價	平價
低劣	流口水	鮓斗
低劣的材料	流料
低劣的計策	屎坑橋	屎坑計
低劣的辦法	屎坑橋	屎坑計
低聲細語	陰聲細氣
低能兒	低能兒童
低賤	cheap
低速	低波
低速檔	低波
低速行駛	低波行駛
低速開車	低波行駛
低頭	耷低頭
住下來	住落嚟
住口	停口	收口	收聲	閘住	閘住把口
住嘴	停口	收口
住在	住响	住喺
住宅	竇口
住宅小區	屋苑
住手	停手	收手
住處	竇口
住院	入廠	留醫
佔	掗	霸
佔上風	執贏
佔下風	執輸
佔不了他的便宜	咬佢唔入
佔不了便宜	咬唔入
佔人便宜	揩油
佔位	霸位
佔位子	霸位
佔位置	掗位	霸位
佔便宜	執到著數	執贏	抽水	搲著數	搵人笨	搵人老襯	搵笨	搵著數	索油
佔地方	掗埞	掗拃
佔好位子	霸靚位
佔據	霸
佔著毛坑不拉屎	生人霸死地
何事	乜事	咩事
何必	使乜
何止	點止
佛寺	齋堂
佛肚竹	觀音竹
作…的投機買賣	炒
作主	話事
作保證	拍心口
作保證金信用的投機買賣	炒孖展
作別	講拜拜
作嘔	反胃	想嘔
作外幣的投機買賣	炒外幣
作威作福	也文也武
作孽	折墮
作弄	整古	老點	跣
作弊	出千	出猫招	出老千	出術	出貓	出貓仔	超技術	通水	造馬
作弊紙	貓紙
作房地產的投機買賣	炒樓
作文	paper
作法	造法
作秀	做騷
作罷	罷就
作聲	出聲	開聲
作股票的投機買賣	炒股票
作風洋化	鬼聲鬼氣
作鳥獸散	散水
你以為	你估
你們	你哋
你們的	你哋嘅
你們自己	你哋自己
你們自己的	你哋自己嘅
你好！	哈佬
你對這個問題有什麼看法	你點睇
你怎麼看	你點睇
你怎麼看這個問題	你點睇
你感覺怎樣	你見點
你把這件事情好好想一想吧	攝高枕頭諗清楚
你把這件事情想清楚吧	攝高枕頭諗清楚
你推我我推你	推推㧬㧬
你沒長眼呀？	趕住去投胎咩
你猜	你估
你猜猜看	你估
你的	你嘅
你的為人	你個人
你看	嗱
你真好心	你好有心	真有心
你知道嗎？	你知唔知
你考慮你自己的事	你諗你，咪諗過隔籬
你自己拿主意	你諗你
你自己的	你自己嘅
你說怎麼辦就怎麼辦吧	你話點就點
你過獎了	唔係噉話，你過獎喇
你還想怎麼樣	仲想點
佯做	詐假意
佯睡	扮瞓	詐瞓
佯裝	詐
佯裝愚蠢	扮豬食老虎
使	令到
使人失足	跣西瓜皮
使人生氣	激
使出不光彩的手段	出橫手
使出詭計	出術	出貓招
使勁	出力	大力
使勁地聊天	起勢傾
使勁拉	出力擝
使勁敲打	大力敲打
使喚	使	笛
使壞	𢷮鬼
使得	令到
使性子	使頸
使用者	用家
使盡渾身解數	出盡八寶	落足功夫	落足心機
使自己愣了一下	打突	打突兀
使詐	出猫招	出貓招
侃大山	傾世界	傾偈
來	嚟
來不了	唔嚟得
來不及	唔切	唔得切	嚟唔切	嚟唔得切	未得切	趕唔切	趕唔得切
來不及了	等唔切
來不及做	做唔切	整唔切
來不及剎車	煞唔切掣
來不及吃	食唔切
來不及回答	答唔切
來不及寫	寫唔切
來不及弄	整唔切
來不及抄	抄唔切
來不及煞車	耷唔切
來不及看	睇唔切
來不及躲開	縮唔切	避唔切
來不及通知	通知唔切
來世	第世
來亨雞	力行雞
來人哪！	人嚟	人嚟！
來人啊！	人嚟	人嚟！
來人！	人嚟	人嚟！
來勁	㷫	㷫起嚟
來勁兒	嚟神
來去匆匆	滾水淥腳
來往	上落
來得及	嚟得切	得切	趕得切
來得正好	嚟得啱
來得正是時候	嚟得啱
來晚	嚟遲
來晚了	嚟遲咗
來月經	姨媽到	行經	親戚到
來真的	見真章
來自	嚟自
來自香港的人	港客
來這裡	嚟呢度
來遲	嚟遲
來遲了	嚟遲咗
來頭	波路
來頭大	猛料
侍者	企堂
供不應求	渴市
依仗	恃
依你看	計你話
依你說	計你話
依我看	計我話
依我說	計我話	講起又講
依樣畫葫蘆	有樣學樣	照板煮碗	照板煮糊
依照常例	循例
依靠	倚憑	傍	挨憑	靠
便宜	cheap	平	爛賤	相宜	著數
便宜了…	益
便宜得很	平到飛起
便宜沒好貨	執到都喊三聲	平嘢唔靚
便宜貨	cheap嘢	夜冷	夜冷貨	平嘢
便溏	屙爛屎
便當	飯盒
便秘	結恭
便箋	拍紙簿
便車	順風車
俄國菜湯	羅宋湯
俄式番茄湯	羅宋湯
俄羅斯紅菜湯	羅宋湯
俊俏	青靚白淨
俊男	靚仔
俊男美女	型男索女	靚仔靚女
俗不可耐	俗到死
俗氣	俗骨
俗氣得要命	俗到死
俗話說	俗語話	俗語話齋
保存	keep
保安	secu	實Q	石Q
保安人員	secu	實Q	石Q
保安員	secu	實Q	石Q
保證	包	拍心口
保證搞好	包掂	包攪掂
保證辦妥	包掂	包攪掂
保證金	孖展
保護費	陀地費
保險	實穩	燕梳	穩陣
保險桿	泵把
保險櫃	夾萬
保險沒錯	實穩冇錯
保險短褲	打底褲
保險箱	夾萬
保險絲	灰士
保險絲燒了	燒咗灰士
信口胡言	隨口噏
信口胡說	隨口噏
信口開河	滾紅滾綠	爆響口	隨口噏
信口雌黃	隨口噏
信得過	有腰骨
信息技術	資訊科技
信息長	資訊總監
信息閉塞	咁盟塞
信瓤兒	信肉
信用	口齒
信用卡	信用咭
信紙	信肉
修	整
修不好	整唔翻
修好	整翻好
修橋補路	修橋整路
修理	修整	整翻
修理好	整翻好
修理水渠	修水圳
修理水龍頭	修整水喉
修理汽車	整車
修理渠道的	通渠佬
修理瓦漏	執漏
修車	整車
俯下	烏低
俯伏	伏
俯泳	蛙式
俯臥	仆
俯臥撐	掌上壓
個兒大	大個	大隻
個兒小	細個	細粒	細細粒	細隻
個子大	大隻	肥屍大隻
個子大大的	大隻騾騾
個子小	一粒色	細粒	細細粒
個子小的人	豆丁
個案	畸士
們	哋
倒	冧	斟
倒下	跌低
倒下來	冧
倒也是	又係噃
倒出	倒瀉	斟出
倒出來	倒出嚟	斟出嚟
倒在床上	笪落床
倒塌	倒冧	冧
倒外幣	炒外幣
倒得溢出	斟瀉
倒扣	仆轉	扱
倒掛金鐘	吊鐘
倒撒了	倒瀉
倒數第一	包尾	第屘	老番睇榜第一
倒數第二	屘二
倒楣	黑	黑仔
倒楣了	衰咗
倒水	斟水
倒爺	炒友	炒家
倒立	倒樹蔥
倒胃口	唔開胃
倒茶	斟茶
倒蓋	扱
倒買倒賣	炒	炒買炒賣
倒買倒賣樓房	炒樓
倒賣分子	炒友
倒賣外幣	炒外幣
倒賣房產	炒業
倒退	打倒褪
倒運	運滯
倒過來	打倒掟
倒過來放	打倒掟放
倒酒	斟酒
倒醬油	斟豉油
倒閉	冧檔	執	執笠	𢫏斗	𢫏旗	𢫏檔
倒霉	折墮	當衰	當黑	黑	黑仔	𠹳
倒霉了	衰咗
倒霉透了	黑過墨斗
倒霉鬼	掃把星	晦氣星	衰神
倒馬桶	倒屎塔
倒騰買賣	炒
倔	牛精
倔強	倔	梗頸	牛頸	硬頸
倚老賣老	恃老賣老
借光	企歪啲	借一借	借借	借歪	借歪啲	唔該借歪
借給	借畀
借過一下	企歪啲	借一借	借歪	借歪啲	唔該借歪
借錢	度水
值	抵	筍
值回票價	值晒票價
值夜	睇夜	睇更
值夜班	當夜	當夜更
值得	抵
值得去	去得過
值得吃	抵食
值得的	值得嘅
值得看	有睇頭	睇得過
值得考慮	有得諗
值得買	抵買
值日班	當日更
值班	當更
值白班	當日更
值錢	抵錢
假唱	咪嘴	夾口型
假客氣	讕客氣
假意做	詐假意
假摔	插水
假東西	流料
假正經	讕正經
假洋妞	竹升妹
假洋鬼子	半唐番	竹升	竹升仔
假消息	流料
假的	流
假睡	瞌	詐瞓
假票	假飛
假裝	扮作	扮到	裝假狗	詐	詐假意	詐諦	讕
假裝不知道	詐唔知
假裝排場	讕架勢
假裝正經	讕正經
假裝睡著了	詐瞓
假裝糊塗	搏傻	詐癲扮傻
假貨	A貨	朱義盛	朱義盛貨
偉哥	威而鋼
偏偏	硬係
偏僻	惰角	背	背角
偏僻的地方	山卡罅	山卡罅嘅地方	惰角地方
偏僻的地方或郊區	埠仔
偏地方	惰角地方
偏食	揀飲擇食	擇食
做	攪	整
做一個木桶	鬥個木桶
做一套衣服	聯一脫衫
做一張桌子	鬥一張枱
做一身衣服	聯一脫衫
做下去	做落去
做不了	做唔嚟	做唔掂
做不了聲	唔出得聲
做不來	做唔嚟	做唔掂	整唔掂
做不到	做唔到	做唔掂
做不完	做唔完	做唔晒	禁做	禁攪
做不成	冇得做
做中間人	做艇仔
做主	揸莊
做乞丐	揸兜
做了一個夢	發咗一個夢
做了一段時間	做做吓
做事不留餘地	有風駛盡𢃇
做事動作慢	湆手湆腳
做事很細心	做嘢好好心機
做事快	快手快腳
做事拖拉	揼時間
做事搞砸的多而辦好的少	撞板多過食飯
做事有頭無尾	冇手尾
做人	份人
做什麼也白搭	乜都假
做兼職工作	做part-time
做出來	做出嚟
做口試	考柯佬
做噩夢	發噩夢
做夢	發夢
做夢也沒有見過	發夢都未見過
做好	攪掂
做好善後工作	跟進
做好準備	預
做妓女	做雞
做媒人	揸大葵扇	撥大葵扇
做客去了	去咗飲
做小動作	整古弄怪	整鬼整怪
做工	打工
做得不對	唔著
做惡夢	發噩夢
做愛	撲嘢	造愛
做慈善	開善堂
做手腳	出貓	出貓仔	超技術
做手術	入廠大修
做投機生意	炒賣
做暗娼	做雞
做木匠活	鬥木
做木器	鬥木
做木工	鬥木
做木工活兒	鬥木
做法	造法
做法事	打齋
做無米之炊	煲冇米粥
做男妓	做鴨
做禮物	做手信
做空頭生意	炒買炒賣
做筆記	落簿
做聲	出聲
做菜	整餸	煮餸
做著做著	做做吓
做記錄	落簿
做買賣的	生意佬
做賬	做數
做違法的事	搏拉
做錯	擺烏龍	擺老烏
做錯了	衰咗
做錯事	做錯嘢
做零工	打散工
做零用	做散使
做電燈泡	做電燈膽
做面部美容	做飛數
做頭兒	揸莊
做飯	煮飯
做鬼臉	整古弄怪	整鬼整怪
做黑社會份子	行蠱惑
停下	停低	泊低
停下來	停低	停低腳	停定	停落嚟	泊低
停下腳步	停低腳
停住	窒住
停好	停定
停手	歇手
停放	泊	泊低
停業	執笠	𢫏旗
停止	閘住
停止從影	息影
停止營業	執笠	收檔
停泊	泊
停留下來	落腳
停當	定當
停車	泊	泊低	泊低架車	泊車
停車位	泊車位	車位
停車場	泊車場
停車收費碼表	收費咪錶	泊車咪錶
停靠	泊	泊低
健壯	大嚿
健康	康健	弗
健忘	冇耳性	冇記性	水過鴨背
健忘的人	大頭蝦
健碩	大嚿
健談	傾得	好傾	好傾好講	好氣	長氣
側著身子	打側
側著身子坐	打側坐
側著身子睡	打側瞓	打側身
偶爾	一時時	久不久	耐中	耐唔中	耐耐	間中
偷	撻	鼠
偷偷地拿走	鼠
偷偷地看一下	䁓吓先
偷偷地瞧一瞧	䁓吓先
偷偷溜走	鼠
偷偷潛入	鼠
偷偷的	靜靜雞
偷偷瞧	睄
偷吃	偷食
偷吃不懂擦嘴	偷食唔抹嘴	偷食唔會撟嘴	偷食唔識抹嘴
偷吃禁果	偷嗒
偷嚐禁果	偷嗒
偷回來	撻翻嚟
偷天換日	偷龍轉鳳
偷學	偷師
偷工減料	慳水又慳力
偷情	偷嗒	偷食
偷懶	偷雞	吞樸	蛇	蛇王
偷拍	偷影
偷東西	撻嘢	鼠嘢
偷梁換柱	偷龍轉鳳
偷渡	屈蛇
偷渡的少年兒童	小人蛇
偷渡組織者	蛇頭
偷渡者	人蛇
偷渡集團的頭兒	蛇頭
偷看	䁓	偷睇	瞄
偷看一眼	瞄一眼
偷窺	䀹嘢	䁓
偷竊	鼠嘢
偷襲	出貓招
偷錢包	打荷包
偷錢包的小偷	荷包仔	荷包友
偷閒	偷雞
偽劣產品	水貨
偽裝	裝假狗
偽造的物品	朱義盛	朱義盛貨
傀儡	扯線公仔
傍晚	挨晚	諵光黑	齊黑
傑克遜維爾	積遜威爾
傘	遮
傘枝	遮骨
傘桿兒	遮柄
傘桿兒的尖端	遮柄
傘的金屬條	遮骨
傘的骨架	遮骨
備用	士啤
備用物	士啤
備用車輪	士啤肽
傢伙	友	架罉
傢俱	傢俬
催促	趲
傭人	亞四
傲慢	塵	大嘢	大資爺	高竇
傲慢的人	白霍友	高竇貓
傲慢自大	高高竇竇
傳呼中心	call台
傳呼機	call機
傳小抄	通水
傳染	嘢	惹	惹埋
傳染到	惹埋
傳染給	惹畀
傳染給…	嘢埋…
傳染給我	嘢埋我
傳真	fax
傳票	告票
傳統式樓房	唐樓
傳聲器	咪	咪高峰
債務	街數
傷	損	親
傷亡慘重	一頸血
傷寒	大熱症
傷痕	瘀	𤶸
傷胃	濕滯
傷腦筋	擇使	肴晒頭	肴頭	頭大
傻	傻更	喪	懵	戇	戇喪	霎戇
傻丫頭	傻女	傻妹
傻乎乎	傻更更
傻乎乎的人	豬頭柄
傻了	食懵咗
傻傻的	懵吓懵吓
傻冒	羊牯
傻女人	傻婆
傻子	亞傻	亞茂	傻人	傻佬	傻瓜	喪仔	壽頭	懵仔	戇佬	木嘴	水魚	發瘟雞	盲毛	茂尼	豬頭嘜	豬頭柄
傻小子	傻仔	吽仔	壽仔
傻愣愣	木木獨獨
傻瓜	亞傻	亞茂	傻人	傻仔	傻佬	傻婆	傻更	壽仔	壽頭	懵仔	懵佬	戇居	水魚	羊牯	老襯	豬頭嘜	豬頭柄	霎戇
傻瓜才理他	睬佢都傻
傻笑	熠熟狗頭
傻笨	壽
傻裡傻氣	傻傻更更	癲癲廢廢
傻里傻氣	傻傻哋
傻頭傻腦	傻傻更更	壽頭壽腦	戇居居	戇戇哋	粉腸
傻頭傻腦的人	亞福
傾倒	倒瀉
傾斜	斜
傾盆大雨	落狗屎
傾盡全力	搏到盡
僅	淨
僅僅	㗎咋	淨	淨係
像	似	學	學似
像…似的	…噉頭	好似…噉
像個樣子	似模似樣	有型有款
像斷線風箏的人	冇尾飛陀
像極了	似到極	似足
像模像樣的	似模似樣	有型有款
像樣	似樣
像話	似樣
僥幸逃生	執翻條命
僭越	讕
僵硬	戾偈
價廉物美	又平又靚
價格	盤口
價錢便宜	價錢相宜
僻靜	背
儀錶	咪錶
儘力哄說	落足嘴頭
儘管	即管
儘管如此	係就係
儘裡邊兒	埋便
償命	填命
優格	乳酪
優酪乳	乳酪
優點在於	勝在
儲存	儲
儲物房	士多房
儲藏室	士多房
元	個	皮	蚊	蚊雞	銀錢
元宵	湯丸
元宵節	上元誕	元宵	新十五	正月十五
兄妹倆	兩兄妹
兄妹兩個人	兩兄妹
兄弟一場	一場兄弟
兄長	大佬
充	讕
充充飢	頂吓肚
充其量	極其量	至多
充排場	讕架勢
充正經	讕正經
充英雄	扮英雄
充電	叉電
充飢	頂肚	頂肚餓
兆頭	意頭
兇	惡	狼	狼命	狼死	狼胎	猛	黑面
兇兇的	惡亨亨	惡揗揗
兇巴巴的	惡揗揗
兇悍	棖雞
兇惡	惡死	惡爺	猛	黑面
兇殘	勢兇夾狼
兇狗	惡狗
兇狠	勢兇夾狼	狼	狼命	狼死
兇狠惡毒	番鬼
兇狠的狗	惡狗
兇猛	勢兇夾狼	狼	狼命	狼死
先別去	咪去住
先在烤箱裡烘過的三明治	烘底
先墊著	賒住先
先生	亞sir	亞生	生
先看一下	睇吓先
先等一下	等陣先
先走	走先
先躲個懶兒	蛇吓先
先這樣	係噉先
先這麼著吧	係噉先	係噉先喇
光	一味	單係	得	淨	淨係
光亮	光猛
光亮耀眼	光巉巉	光棖棖
光做	做埋晒
光彩的	馨香
光明正大	行得正，企得正
光是	一味	單係
光棍	單身寡仔	寡佬
光棍兒一個	一支公
光溜溜	光脫脫
光滑	滑捋捋	滑溜
光滑得發亮	炩
光盤	光碟	鐳射唱片
光看不買	齋睇唔買
光禿禿	光脫脫
光線充足	光猛
光背	唸口黃
光著腳	打赤腳
光說不做	口響	大隻講	得個講字	得把口	得把聲
光說不幹	得把聲
光說不練	得個講字	齋噏
光說廢話	齋噏
光靠一把口	得個講字
光頭	撻頭
光顧	吼	吼斗	幫襯
光麵	淨麵
克他命	K仔
克拉	卡
兌	搏	摳
兌子	搏	鬥棋
兌換	找換	暢
兌換外幣	找換外幣
免不了	少不免
免得	免至
免談	冇得傾
免談！	冇得傾呀
兒大不由娘	仔大仔世界
兒女	仔女
兒女自有兒女福	仔大仔世界
兒媳	家嫂
兒媳婦	家嫂	心抱
兒子	亞仔	仔
兒孫自有兒孫福	仔大仔世界
兔子	兔	兔仔
兔崽子	衰仔
兔脣	崩口
兜	屈
兜兒	衫袋	袋
兜底兒	穿煲
兜著	豆住
兜風	遊車河
入不敷出	唔夠皮
入住	入伙
入夢	搵周公	見周公
入屋偷竊	爆夾	爆格
入席	埋位	埋席
入座	埋位	埋席
入手	埋手
入時	型
入賬	入數
入迷者	粉絲
入鄉隨俗	入屋叫人，入廟拜神
入門	入行
入院	入廠
內兄	大舅
內向	古縮
內地姑娘	大陸妹
內地青年	大陸仔
內奸	內鬼
內定	造馬
內定的	造馬
內幕消息	貼士
內弟	舅仔
內弟婦	細嬸
內弟媳	細嬸
內心不忿	條氣唔順
內燃機	偈
內臟	雜
內行	熟檔	熟行	行家
內行人	行家
內衣	底衫
內褲	底橫	底褲
內鬨	鬼打鬼
全	通
全力	瞓身
全力投入去幹	瞓晒身落去
全力支持	撐到恆
全包了	一腳踢
全因為	皆因
全好	斷尾
全完了	乜都冇晒
全家	冚家	成家	通屋	闔府
全家倒楣	冚家富貴
全家安康	闔府安康
全家死光	冚家鏟
全家死絕	冚家鏟
全對	啱晒
全忘了	水過鴨背
全拿回去	攞晒翻去
全書	通勝
全滿	頂籠
全濕透了	濕晒
全無氣色的樣子	殘
全盤失敗	一鑊熟
全神貫注	落足眼力
全自動汽車	自動波
全說中了	講中晒
全身	周身	成身
全身不舒服	週身唔聚財
全身投入	瞓身	瞓身搏盡
全身直打哆嗦	周身打冷震	成身打冷震
全身都濕透了	周身濕晒	成身濕晒
全部	冚唪唥	晒
全部在	喺晒
全部拿回去	攞晒翻去
全部算好了	計晒
全部自己吞沒	托水龍
全部遭殃	一鑊熟
全都明白了	明晒
全都死光	一鑊熟
全靠你了	指擬你
全齊了	齊晒
兩下子	兩度散手
兩世為人	死過翻生
兩人同睡一床	孖鋪
兩人爭鬥	面阻阻
兩個人一起吃飯	撐枱腳
兩個人擠一張床	孖鋪
兩個人走在一起	行孖咇
兩千	二千
兩夫婦	兩公婆
兩性人	半男女
兩手準備	兩睇
兩毛五	兩毫半
兩毛五分	兩毫半
兩父子	兩仔爺
兩百	二百
兩看吧	兩睇
兩眼冒火	眼火爆
兩眼發愣	眼定定
兩眼發直	眼定定
兩眼發直地看	眼定定噉望
兩碼事	牛頭唔搭馬嘴
兩耳搧風	兜風耳
兩腳釘	魚尾釘
兩萬	二萬
兩葷一素	一齋兩雜
兩說著	兩睇
兩邊	兩便
兩邊推光的髮型	剷青
兩面	兩便
兩面派	兩頭蛇	斑馬佬
兩頭堵死	盟籠
八九不離十	七七八八
八仙桌	八仙枱
八十多歲	八張幾
八卦的	八
八哥	了哥	鷯哥
八字不合	八字唔夾
八字還沒一撇	十畫未有一撇	十畫都未有一撇
公公	大人公	家公	老爺
公共汽車	大巴	巴士
公共汽車站	巴士站
公司三明治	公治
公司的開支	公數
公家的開支	公數
公寓	樓
公德觀念	公德心
公文包	公事包
公文箱	喼
公正嚴謹	君真
公正地處理	揸正嚟做
公牛	牛公	牛牯
公狗	狗公
公益機構	善堂
公羊	羊公
公老虎	老虎公
公豬	豬公
公貓	貓公
公車	大巴	巴士
公車司機	巴士佬	巴士司機	巴士車長
公車站	巴士站
公道	君真
公開化	地面化
公開發行股票	上市
公雞	生雞	雞公
六十多歲	六張幾
六指兒	孖指
共同	兩份
共同出資	合錢
共同地	兩份
其實	查實
典型人物	人辦
典當	按
兼職	part-time
再	先	先至	至
再來	再嚟
再來一個	安哥
再來一次	再嚟過
再制	翻抄
再嘗試一次	再嚟過
再好不過	正晒
再嫁	翻頭嫁
再怎麼說也	假假哋
再拿出來	攞翻出嚟
再會	遲啲見
再生	翻抄
再盛飯	添飯
再盛點兒飯	添飯
再見	拜拜
再試一下	再嚟過
再說	再講
再說吧	睇過點
再過一段時間	遲吓
冒	標
冒出	標出
冒名頂替	頂包
冒失	擒青
冒汗	標汗
冒火	火起	發老脾
冒火了	扯晒火
冒煙	出煙	標煙
冒牌貨	朱義盛	朱義盛貨	水貨
冒起煙	出煙
冒險	搏
冗長發言	拉布
冗長辯論	拉布
冤大頭	水魚
冤屈	屈	老屈
冤枉	好心著雷劈	屈	老屈
冥鈔	冥鏹	陰司紙
冬天	天時冷	天時凍
冬至	冬
冬蓉酥	老婆餅
冰	雪
冰凍	雪藏
冰棍	雪條
冰棍兒	雪條
冰櫃	冰箱
冰水	凍水	雪水
冰涼	浸浸涼	涼浸浸
冰淇淋	雪糕
冰淇淋工廠	雪糕廠
冰淇淋蛋卷	雪糕筒
冰淇淋車	雪糕車
冰磚	雪批	雪糕批
冰箱	雪櫃
冰花蛋球	沙翁
冰鎮汽水	雪藏汽水
冰鎮西瓜	雪藏西瓜
冰镇	雪藏
冰雹	雪珠
冰鞋	雪屐
冷	凍
冷不防	失驚無神
冷冰冰	凍冰冰
冷咖啡	凍啡
冷咖啡加奶茶	凍鴛鴦	凍鴛鴦茶
冷咖啡茶	凍鴛鴦	凍鴛鴦茶
冷得直打哆嗦	凍到揗揗震
冷得要命	凍到死
冷檸檬茶	凍檸茶
冷死了	凍到死
冷水	凍水
冷水消腫	凍水散瘀
冷淡	倔情
冷的時候	天時冷
冷笑話	爛gag
冷藏	雪藏
冷藏的肉	雪藏肉
冷言冷語	單單打打
冷酷	cool
冷鍋裡撿了個熱栗子	冷手執個熱煎堆
冷靜	淡定	老定
冷颼颼	浸浸涼	涼浸浸
冷飲	凍飲
冷飲店	冰室
准	奉旨
准不	奉旨唔
准頭兒	眼水
凍	冷
凍僵了	冷到硬咗
凍得上牙打下牙	周身打冷震	成身打冷震
凍檸檬可樂	凍檸樂
凍肉	雪肉	雪藏肉
凍豬肉	雪豬
凡士林	花士令
凡是	但凡	凡係	逢親
凱	傾	王
凱子	老襯
凳子	凳	凳仔
凹進去	凹
凹陷	凹
出一口氣	出啖氣
出主意	出計	諗計	諗計仔
出了一身冷汗	標晒冷汗
出了大問題	揩鑊
出了故障	神	神咗
出了毛病	神	神咗
出了點問題	神神地
出來	出嚟	出翻嚟
出來消遣行樂	we𠿭𠿭	出嚟蒲	𠿭
出來混	出嚟撈	出嚟行	行蠱惑
出來玩	we𠿭𠿭	出嚟蒲	𠿭
出入孔	沙井
出冷汗	標冷汗
出剪票口	出閘口
出去	去街
出去了	行開咗
出去玩	出去蒲
出去走走	出去行吓
出口	賣埠
出售	放盤
出售廣告	放盤廣告
出唱片	出碟
出問題	呢次弊
出國	過埠
出國旅遊觀光	遊埠
出國留學	浸鹹水
出婁子	撞板
出專輯	出碟
出殯	出山
出氣	扽氣
出汗	標汗
出洋	過埠
出洋留過學	浸過鹹水
出獄	出冊	放監
出現破洞	穿窿
出生	出世
出生入死	打生打死
出生證	出世紙	出生紙
出瘀血	瘀
出瘀血了	瘀咗
出盡風頭	攞晒彩
出租汽車	的士
出租車	的士
出租車司機	的士佬
出色	叻
出芽	標芽
出過國留學	浸過鹹水
出遠門	出埠
出醜	剃眼眉	甩鬚
出鍋	起鑊
出門	出街	出門口
出門兒	出街	出門口
出雙入對的人	孖公仔
出風頭	出位	扮嘢	抛浪頭	攞彩	風流
出鬼點子	出蠱惑	出術	扭計
出點子	諗計	諗計仔
刁蠻	扭計	番鬼
分不開	分唔開
分作兩份	兩份
分外	零舍
分娩	臊
分家	分身家
分手	拆檔	掟煲	散	斬纜	飛咗
分手了	散咗	甩拖
分期付款	供
分期付款買車	供車
分派學位	派位
分發	派
分發獎金	派彩
分發請帖	派帖
分財產	分身家
分送	派
分配	派
分配學校	派位
分配學額	派位
分量大	唔係嘢少
分錢	崩
分間樓宇單位	劏房	房中房
分頭逃走	散水
切去麵包皮的三明治	飛邊
切成塊狀	斬件
切脈	睇脈
切菜	切餸
切開	劏開
切開西瓜	劏西瓜
刑事情報科	CIB
划	扒
划不來	冇數為	制唔過	唔制得過	唔化算	唔抵	唔為得過
划子	艇仔
划小艇	扒艇仔	撐艇仔
划得來	制得過	化算	為得過
划拳	拳手	猜拳	猜枚
划算	化算	抵買
划船	扒	扒艇仔	撐船	撐艇仔
划龍船	扒龍船
初來乍到	初嚟甫到
初次	頭威頭勢
判若二人	差天共地
判若雲泥	差天共地
別	咪	唔好	第
別人	人哋	第個人
別人的事用不著你來費心	你諗你，咪諗過隔籬
別再幹了	收檔罷啦
別再說了	冇再講啦
別動	咪喐	咪攪	唔好喐
別只想著…	咪掛住…
別只顧著…	咪掛住…
別名	朵
別吵	咪嘈	唔好嘈
別吵了	一人少句
別哭	唔好喊
別在意	唔好計帶
別妄想	開胃咯
別客氣	使乜咁客氣	唔使客氣	唔好客氣
別害怕	冇有怕	唔使驚
別忘了	記住
別怕	唔使驚
別急	唔好心急
別惦記著…	咪掛住…
別想	諗都唔好諗
別拿我開玩笑	講笑搵第樣
別指望	咪指擬	唔使指擬
別搞	咪攪
別擔心	唔好擔心
別暴殄天物	食得唔好嘥
別浪費	食得唔好嘥
別無選擇	冇得揀
別癡心妄想	咪指擬	唔使指擬
別的	第	第二	第個
別的地方	第二度	第度	第處
別算我一份	唔好預我
別緻	趣怪	骨緻
別胡搞	咪攪
別處	第二度
別說	咪話	唔好話	唔好講
別走	咪走
別跑	咪走
別逃	咪走
別這麼說	唔係噉話
別過臉去	擰歪面
別針	扣針
別麻煩我了	咪攪我
利害	手瓜起腱	𠹳
利害的做法	𠹳嘢
利息	息口	花紅
利潤	花紅
利用	過橋
利用別人	借人過橋
利益	頭啖湯
利索	快脆	爽手
刪剪	cut
别處	第度
别說	閘住
刮了一點痕跡	劃花
刮傷	鎅親
刮出一點小傷口	鎅親
刮出一點痕跡	鎅花
刮台風	打颱風
刮破	鎅親
刮破了一點油漆	劃花
刮臉	剃面
刮臉刀	鬍鬚刨	鬚刨
刮錢	扒錢
刮風	翻風
刮鬍子	剃鬚
到…的時候了	夠鐘
到一邊去	死開	過主
到境外去旅遊	遊埠
到天亮	通頂
到底	究竟	話晒
到時候	到其時	到嗰陣	到時	到時到候
到時候再說	到時睇吓點先
到時再說	睇嚟湊
到時間了	夠鐘	夠鐘數
到最後	冧屘
到極點	頂籠
到此為止	係噉先
到海外	出埠
到海外去旅遊	遊埠
到盡頭	頂籠
到目前為止	現暫
到處	周圍	周處	四周圍	四圍	度度	通處	通街	隨街	頭頭
到處亂串	貢吓貢吓	貢嚟貢去
到處亂摸	摸身摸勢
到處亂躥躥	亂咁舂
到處借錢的人	船頭尺
到處去詆毀別人	唱衰
到處去遊玩	行地方
到處奔波	四圍撲	頻頻撲撲
到處找票	撲飛
到處碰上倒霉事	頭頭碰著黑
到處籌款	搲水	撲水
到處籌款的人	船頭尺
到處詆毀他	唱衰佢
到處說人壞話	唱衰
到處說他的不是	唱衰佢
到處說他的壞話	唱衰佢
到處說别人的不是	唱衰
到處說某人的壞話	唱
到處賺錢	搲水
到街上	去街	落街
到達	到埗	抵埗
到頭	頂籠
到點	夠鐘
到點了	夠時候咯
制伏	治
制動系統	逼力
刷	㨘	油
刷不掉	㨘唔甩
刷乾淨	㨘乾淨
刷卡	碌咭
刷洗	㨘
刷爆	碌爆
刷爆信用卡	碌爆咭
刷牆	油灰水
刷牙缸	𠺘口盅
刷石灰水	油灰水
刺	劖	啡	拮	督	簕	錐
刺傷	督親
刺兒頭	攪屎棍
刺到出血	拮出血
刺激	激凸
刺目	光巉巉	光棖棖	巉	巉眼	棖	棖眼
刺眼	巉	巉眼	棖	棖眼
刺破	拮穿
刺穿	督爆
刺耳	吵耳
刻意	專登
刻薄	mean
剁	斫
剁成塊兒	斬件
剃	剷
剃光頭	剷光頭
剃鬚刀	鬍鬚刨	鬚刨
削	㓟
削價	減價
削減	cut
削皮	㓟皮
削菠蘿皮	㓟菠蘿皮
削蘋果	㓟蘋果
削鉛筆	㓟鉛筆
削鉛筆器	筆刨	鉛筆刨
削鳳梨皮	㓟菠蘿皮
剋扣	刮削
前一天的	隔夜
前一天的剩菜	隔夜餸
前一天的剩飯	隔夜飯
前一段時間	先一排	先嗰排	先嗰輪	前嗰排	前嗰輪	早一排	早排
前一陣兒	先一排	先嗰排	先嗰輪	前嗰排	前嗰輪	早一排	早排
前些日子	先一排	先嗰排	先嗰輪	前嗰排	前嗰輪	早一排	早排
前些時候	先一排	先嗰排	先嗰輪	先排	前嗰排	前嗰輪	早一排	早排
前任女朋友	過去式
前任男朋友	過去式
前天	前日
前女友	過去式
前後	頭尾
前後搖晃	岌
前晚	先晚
前景光明	大把世界
前生缺乏修行	前世唔修
前男友	過去式
前科	案底
前菜	頭盤
前言不搭後語	牛頭唔搭馬嘴
前輪	前轆
前邊	前便
前陣子	先一排	先嗰排	先嗰輪	前嗰排	前嗰輪	早一排	早排
前面	前便
前額	額頭
剎車	收油	煞掣
剎車裝置	逼力
剎那	霎時	霎時間
剔	簽
剔去骨頭	起骨
剔手旁兒	剔手邊
剔牙	撩牙
剔牙縫	撩牙罅	簽牙
剔透	通透
剔骨頭	起骨
剖魚	劏魚
剛	啱
剛入門	初初入行
剛剛	啱先	啱啱	正話	踏正	頭先
剛剛不久	較早前	較早時
剛剛來到	初嚟甫到
剛剛加入這一行	初初入行
剛好	剛啱	啱	湊啱
剛好被看到	䁓到正
剛好讓人…到	…到正
剛好讓人給抓到	捉到正
剛才	剛啱	啱先	正話	求先	頭先
剝削	刮削
剝皮	㓟皮
剩下	剩	剩低	剩翻	落剩
剩下…而已	得翻
剩下爛攤子	爛尾
剩下的	食剩
剩菜	隔夜餸	餸尾	餸頭餸尾
剩貨	籮底橙
剩飯	冷飯	隔夜飯
剩飯底子	飯腳
剪	飛
剪刀	鉸剪
剪刀石頭布	猜呈沉
剪斷	cut
剪票口	閘	閘口
剪頭髮	飛髮
剮	劖
剮破	纊爛
剮破了	劖損	劖親
副食店	雜貨舖
割	鎅
割破手	鎅崩手
割稻子	割禾
割紙刀	鎅刀	鎅紙刀
割開	劏開
創作對聯	作對
創可貼	藥水膠布
創始者	攪手
創意	新意思
創設條件去冤枉人	屈得就屈
創辦人	攪手
劃破	劖
劃破了	劖損	劖親
劃賬	過數
劇情	橋段
劈	破
劈叉	擘一字
劈哩啪啦	乒鈴𠾴唥
劈柴	柴	破柴
劈里啪啦	乒鈴𠾴唥
劈開	破開
劈開兩邊	破開兩邊
劉海	𩬎
劉海兒	𩬎
劍麻	菠蘿麻
力巴	唔熟行
力氣不夠	唔夠力
力氣大	好力
功效快	快過打針
功效特快	快過打針
加	打
加一碗飯	添飯
加上	兼夾	打	打埋
加入這一行	入行
加塞兒	兼隊	打櫼	櫼隊
加夜班	戙起床板	炒更	開夜
加強注意	醒神
加把嘴	搭嘴
加泰隆尼亞	加泰羅尼亞
加演	安哥
加班	趕工	開O.T.
加班費	補水	過時補水
加菜	加餸
加護病房	深切治療部
加速達到要求	惡補
加飯	添飯
加餐	加菜
劣	兒嬉	曳	豆泥
劣等	流	豆泥
劣貨	地底泥	曳貨	籮底橙
劣質樓房	鹹水樓
助產士	執仔婆	執媽
努	掬
努力	勤力	畀心機	落力
努力做	畀心機做
劫持	騎劫
劫機	騎劫
劫車	騎劫
勁足	掯
勁頭來	㷫起嚟
勃然大怒	激到彈起	發晒老脾
勉勉強強	死死氣
勉強	扤
勉強地	死死氣
勉強維持生活過日子	搵兩餐
勉強過得去	不過不失	麻麻	麻麻哋
勉強還可以	不過不失	麻麻	麻麻哋
勉強餬口	搵兩餐
勉為其難地	死死氣
勒索	㨘牛王	㨘黃魚
勒索別人的金錢	屈水
勒緊褲帶	紮炮
勒脖子	箍頸
動	喐	喐動	鬥
動不了	唔喐得
動不動	喐吓	喐啲	喐親	開口埋口
動不動就	喐啲就
動不動就…	喐親就…
動不動就罵人	亂咁鬧人
動不動就說	開口埋口
動也不動	成嚿佛	成尊佛噉
動也不能動	喐不得其正
動也動不了	喐不得其正
動作	攪作
動作快	啦啦林	啦啦聲	快手	快手快腳
動作快點	快手啲	快馬啲	速速
動作慢	漏氣
動作麻利	快手快腳
動來動去	喐喐貢	喐嚟喐去	震震貢
動個不停	喐喐貢	喐身喐勢	震震貢
動刀動武	開片
動彈	岌	岌岌貢
動彈不得	喐不得其正
動心	心喐喐
動怒	勞氣	扯火	把火	發老脾
動手	喐手
動手做活兒	開工
動手動腳	喐手喐腳	摸身摸勢
動手打人	喐手打人
動武	動粗
動氣	勞氣
動物養膘	槽肥
動畫電影	卡通片
動真格	見真章
動筷子	起筷
動腦筋	食腦
動身	喐身	起錨
動輒	喐吓
勞力士錶	撈
勞動布	牛仔布
勞您駕	好心你
勞碌	頻撲
勞碌奔波	頻頻撲撲
勞神	勞氣	囉氣
勞苦謀生	捱騾仔
勞駕	唔該	唔該晒	好心你
勞鴐	借借
勢必	實行
勢頭大	大陣仗
勵行節約	慳頭慳尾
勸	冧	嘍
勸架	勸交
勺	殼
勺子	匙羹	殼	羹	飯殼
勻稱	勻巡
勾	剔	打剔	積
勾引	勾	撻著	溝
勾引女孩子	溝女
勾引男人	勾佬
勾心斗角	鬼打鬼
勾心鬥角	扭計	狗咬狗骨
勾搭	撻著
勾股定理	畢氏定理
包	藭
包子	包
包工頭	判頭
包幹	一腳踢
包心萵苣	西生菜
包括在內	打埋
包攪	一腳踢
包攬一切	一腳踢
包粽子	包粽
包紮	紮
包菜	椰菜
匆匆忙忙	急急腳	擒擒青青	滾水淥腳
匆匆趕去	急急腳去
匆忙	咧氣	擒青	狼忙
匆忙地	擒擒青
化名	朵
化妝	扮靚	扮鬼扮馬
化子	乞兒
化學	chem
化學肥料	肥田料
化肥	肥田料
北方人	北佬	撈佬	撈鬆
北邊	北便
匯流排	總線
十五分鍾	三個字
十五分鐘	骨
十分	十分之	認真
十分…	夠晒…
十分倒霉	黑過墨斗
十分像	似足
十分兇狠的樣子	惡死能登
十分威風	攞晒彩
十分嬌貴	身嬌肉貴
十分容易	易到極	話咁易
十分忙碌	七個一皮
十分快捷	話咁快
十分憤怒	激到好嬲	激到眼火爆	眼火爆
十分懂人情	熟性
十分熟	爛熟
十分生氣	激奀
十分疼愛	錫晒
十分疼愛你	錫晒你
十分省儉	死慳死抵
十分節儉	慳頭慳尾
十分鍾	兩個字
十天	十日
十年怕井繩	見過鬼就怕黑	見過鬼怕黑	見過鬼都怕黑
十拿九穩	冇走趲	有揸拿
十足	正一	正式
十足的	十足十
十足的一個…的樣子	成個…噉嘅款
十里	堂
十點多	十點幾
千真萬確	實牙實齒	珍珠都冇咁真	的而且確
千萬	千祈
千萬不要	千祈唔好
千萬別	千祈唔好
千金小姐	太子女
升正職	坐正
升等	升呢
升級	升呢
升降架	棚架
升降機	猎
升降機井	猎槽
升降機的門	猎門
午覺	晏覺
午飯	中餐	晏	晏仔	晏晝	晏晝飯
半中不西	半唐番
半公半私	半公私
半摟半抱的	攬身攬勢
半斤八兩	一擔擔
半新不舊	半新舊
半死	死死吓
半死不活	半條人命	半條命
半決賽	準決賽
半瓶醋	半桶水
半生不熟	半生熟
半肥不瘦	半肥瘦
半親不疏	半親疏
半角錢	斗令	斗零
半輩子	半世	半世人
卑鄙的手段	橫手
協作	拍檔
南亞	摩羅
南亞人	摩羅
南亞的	摩羅
南瓜	番瓜	金瓜
南腔北調	半鹹淡
南豆腐	水豆腐
南邊	南便
卡	咭	撠	鯁
卡了魚刺	鯁骨
卡住	撠
卡住了	撠住	撠住咗喇
卡口	樽頸
卡在喉嚨裡	鯁頸
卡帳	咭數
卡死	鯁死
卡片	咭	咭片
卡脖子	捻頸
卡車	貨車
卧室	睡房
印尼傭人	印傭
印度	摩羅
印度人	亞叉	叉佬	叉婆	摩羅	摩羅叉	阿星
印度太太	叉婆
印度女人	叉婆
印度女子	叉婆
印度婦女	叉婆
印度少女	叉妹
印度少年	叉仔
印度男人	亞叉	叉佬
印度的	摩羅
印度阿三	摩羅叉	阿星
印章	印
印花稅	厘印	厘印稅	厘印費
危在旦夕	條命凍過水
危險	牙煙
即使	就算
即將	咁滯
卵	春
卵石	石春
卷狀粉條	腸粉	豬腸粉
卸妝	落妝
卸貨	落貨
卿卿我我	咿咿挹挹
卿卿我我的	埕埕塔塔
厚此薄彼	大細超
厚臉皮	面皮厚
原出處	祖家
原因	因由
原產地	祖家
厭煩	厭
厲害	交關	冇得頂	利害	勁	勁抽	把炮	犀利	飛起
去不了	唔去得
去不成	唔去得
去世	上咗路	仙遊	冧咗	去咗賣鹹鴨蛋	去賣鹹鴨蛋	唔喺度	埋單	拉柴	歎元寶蠟燭	玩完	落下面	行先一步	賣鹹鴨蛋	過身	釘	釘蓋	香
去世了	仙遊咗	去咗	去咗遊埠	收檔	瓜咗	瓜老襯	移咗民	走咗	過咗身	釘咗	釘咗蓋	香咗	𢫏國旗	𢫏旗
去冰	走雪
去喝喜酒	去飲
去外國	過埠
去外面吃飯	出街食	出街食飯
去娛樂場所玩	去蒲
去家裡	上屋企
去小便	揸水
去就去吧	去就去啦
去年	上年	舊年
去旅行	遊埠
去殼	剝殼
去澳門賭錢	過海
去火湯藥	涼茶
去迪斯科消遣行樂	蒲的士高
去邊	飛邊
去酒吧	落吧	落酒吧
去酒吧消遣行樂	蒲吧	蒲酒吧
參差不齊	岩岩巉巉	岩巉	巖巉	巖巖巉巉
參與	共
又…又什麼的	又…又盛
又便宜又好	又平又靚	平靚正
又倒了楣	又衰咗
又倒了霉	又衰咗
又做錯了	又衰咗
又出來	出翻嚟
又吐又瀉	又屙又嘔
又哭又笑	又喊又笑
又哭又鬧	喊到拆晒天
又失敗了	又衰咗
又怎麼樣	又點話
又怎麼樣？	噉點呀？
又怎麼著	又點話
又會又不會	識啲唔識啲
又有什麼呢	又點話
又有什麼問題	又點話
又胖又大	肥屍大隻
又高又大	牛高馬大
叉	交叉
叉兒	交叉
叉號	交叉
叉開腿	擘開兩隻腳
叉開雙腿	擘開兩隻腳
及格	派司
反了	作反
反叛	反骨
反客為主	妹仔大過主人婆
反悔	反口
反應敏捷	靈醒
反應靈敏	話頭醒尾
反正	君之	橫掂
反正都這樣了	橫掂係噉
反派	奸角
反犬旁	戾狗邊	狗爪邊
反眼	眼坦坦
反芻	翻草
反覆考慮	諗諗吓
反轉	仆轉
反面人物	奸角
反駁	頂頸
叔叔	世叔	亞叔
叔父	亞叔
叔祖	叔公
叔祖母	叔婆
取	拎	豆
取出	拎出
取出來	拎出嚟
取勝	食糊
取名	改名
取回	攞翻
取回公道	攞翻公道
取好兆頭	攞意頭
取巧	精
取得全部優秀名次	擸晒網頂
取得全部第一名	擸晒網頂
取得最高成績	擸網頂
取得第一名	擸網頂
取景	攞景
取物	擙
取笑	瘀
取藥	執茶	執藥
取車	攞車
受	畀
受不了	受唔住	唔受得	唔抵得	唔捱得	惡頂	難頂	頂唔住	頂唔順
受不了苦	唔捱得苦
受傷	整親
受到驚嚇而恐懼慌張	失驚忘神	失驚無神
受得了	受得住	頂得住
受挫	撞板
受暑	焗親
受氣	掬氣	揸頸
受涼	冷親
受用	受落
受苦	折墮
受賄	受黑錢
受騙	畀人呃
叛徒	二五仔	反骨仔
叢	蔸
口	啖
口不對心	講一套做一套
口不擇言	口臭
口吃	口震	嘍口	礙口
口岸	埠
口感好	彈牙
口才	口碼
口條	豬脷
口氣大	牙擦擦
口水流個不停	口水嗲嗲渧
口沫橫飛	口水花噴噴
口淡而澀	口嚡脷素
口渴	口乾	頸渴
口瘡	飛螆
口紅	口脣膏	脣膏
口緊	口密	密實
口腔漱洗液	𠺘口水
口腔潰瘍	飛螆
口若懸河	口響	識講嘢
口袋	衫袋	袋
口試	柯佬
口香糖	香口膠
口齒伶俐	牙尖嘴利
古古怪怪的	神神化化
古怪	騎呢
古裡古怪	古靈精怪
古道熱腸	好人事
句子	句
另外的	第二
另類	騎呢
只	唯	單單	淨
只…呢	㗎咋
只不過	惟獨是
只不過樂一樂罷了	得啖笑啫
只不過笑一笑罷了	得啖笑啫
只剩	得個
只剩下	剩得	得個	得翻
只好	唯有
只想著…	掛住…
只是	一味	只係	惟獨是	淨係	獨係
只是一般的水平	交行貨啫
只是說笑而已啦	講吓笑啫！
只會說不會做	會彈唔會唱	識彈唔識唱
只有	剩得	得	得翻	獨係
只有…	得…啫
只有笑的份	得啖笑
只能…啊	㗎咋
只能得到	賺得個
只落得	賺得	賺得個
只說不做	得個講字	得把聲
只顧	一味
只顧…	掛住…
只顧著	一味
只顧著…	掛住…
叫	call	嗌
叫…做	嗌…做
叫不動	嗌唔喐
叫人	call人	嗌人
叫倒好兒	㗾
叫做	嗌做
叫出租車	截的士	截車
叫化子	乞兒
叫名	嗌名
叫喚	嗌
叫救護車	call白車	叫白車
叫東西吃	嗌嘢	嗌嘢食
叫痛	嗌痛
叫花子	乞兒
叫苦連天	喊苦喊忽
叫計程車	截的士	截車
叫車	call車	截的士	截車
叫電梯	撳猎
召妓	叫雞
召集羽翼	班馬
召集黨徒	班馬
叮	啄親	針
叮叮糖	啄啄糖
叮咬	啄	針
叮著	啄親
可不可以	可唔可以	得唔得
可不是嗎	噉唔係
可也是	噉又係
可以	得
可以了	得喇
可以去	去得	去得過
可以回去	扯得
可以想想	有得諗
可以挽回	有得擝
可以斷定	睇白
可以看	睇得過
可以考慮	有得諗
可以討價還價	有價講
可以走	扯得	走得
可以預料的	話得埋
可口	好味
可可	谷古
可心	合心水
可怕	得人怕	得人驚
可怖的樣子	成隻病貓噉
可愛	cute	得意
可愛有趣	得意趣致
可憐	冇陰功	淒涼	陰功
可是	之但係	但係
可有可無的東西	豬頭骨
可笑	笑大人個口
可耕種的土層	泥肉
可能	有之
可觀	𠹳
可觀的事情	𠹳嘢
可靠	穩陣
可靠的信息	堅料
可靠的資料	堅料
台球	士碌架
台階	石級
史特拉斯堡	斯特拉斯堡
右撇子	右撓
右轉	轉右
右邊	右便	右手便
司機	柴可夫
叼	擔
叼著	擔住
叼著一支煙	擔住口煙
叼走	擔走
吃	喫	擦	食
吃下去	食落
吃不下	唔開胃	食唔落
吃不了苦	唔捱得苦
吃不住勁	唔食力
吃不到葡萄說葡萄酸	憎人富貴厭人窮
吃不好睡不著	食唔安瞓唔落
吃不完	食唔晒
吃不消	受唔住	頂唔順
吃不飽	食唔飽
吃了	食咗
吃了沒病	大菌食細菌
吃了還想再吃	食過翻尋味
吃個便飯	食餐便飯	食餐冇餸飯
吃個夠	擦餐勁	擦餐懵	擦餐飽
吃個飽	擦餐勁	擦餐懵	擦餐飽
吃光	食晒
吃剩下的	食剩
吃剩的	食剩
吃剩菜	食餸尾
吃力	抵力
吃午飯	食晏	食晏仔
吃午饭	食晏仔
吃去	食落
吃吃喝喝	飲飲食食
吃啞巴虧	暗啞抵	食死貓
吃回扣厲害	食水太深	食水深
吃夜宵	消夜	食宵夜	食消夜
吃大餐	擦餐勁	擦餐懵	擦餐飽	食翻餐勁嘅
吃奶	啜奶	食奶	食姩
吃完	食埋
吃宵夜	消夜	食消夜
吃年夜飯	團年
吃得下	食得落
吃得多	大食
吃得津津有味	擦餐勁	擦餐懵	擦餐飽	食到嗒嗒聲
吃得虧	抵得諗	抵諗
吃得飽睡得著	食得瞓得
吃慣	食開
吃掉	食晒
吃早餐	食早餐
吃晚飯	食晚飯
吃東西	擦嘢	食嘢
吃水	食水
吃火鍋	打邊爐
吃牛排	鋸扒
吃現成兒	煮到埋嚟先食
吃白食	黐飯餐	黐餐
吃稀飯	食粥
吃素	捱齋	食齋
吃老本	捱穀種	食穀種
吃老本兒	捱穀種
吃膩了	食滯	食滯咗
吃苦	捱苦
吃葷	食雜
吃藥	食藥
吃虧	唔抵	執輸	蝕底	走寶	走雞	輸蝕
吃裡扒外	反骨	食碗面反碗底
吃裡扒外的貨	反骨仔
吃豆腐	索油
吃軟不吃硬	受軟唔受硬
吃軟飯	食軟飯
吃醋	呷醋
吃錯藥	食錯藥
吃閉門羹	摸門釘
吃零食	食口立濕	食閒口
吃飯	喫飯	擦飯	食飯
吃飯不付錢	食霸王飯
吃飽	食飽
吃飽了嗎？	食飽未
吃魚翅	食翅
吃點東西	醫肚
各付各的	AA制
各位	咁多位
各分一半	兩份
各半摻和	對摳
各半攙和	對摳
各走各的路	各行各路
合	撈	眯
合上眼睛	瞌埋眼
合上開關	打掣
合不來	唔合	唔啱咀形	唔啱牙	摳唔埋	水溝油	行唔埋
合不来	唔行得埋
合伙	合份	孖份
合伙騙人	扯貓尾	擝貓尾
合作	合檔	拍住上	拍檔
合唱	夾歌
合在一處	埋堆
合在一起	合埋
合得來	啱feel	啱key	啱偈	啱咀形	啱牙	啱蹺	好合	行得埋
合心意	合心水	合眼緣	啱心水
合意	合心水	啱	啱心水
合格	趴時
合用	啱使	啱用
合眼	瞌	闔眼
合穿	啱著
合算	化算	抵	抵買	為得過	著數
合約	契
合群	埋堆
合股	合份
合該倒霉	當衰
合謀	合計	夾計
合起來	合埋
合身	啱著	啱身
合適	啱	啱feel	啱用	啱聽	啱蹺	襯
合頁	鉸
吉他	結他
吉他手	結他手
吉利	好意頭
吉娃娃	芝娃娃
吊兒郎當	咧啡	咧氣	揦揦西西	揦西
吊胃口	吊癮
吊著	佗住
吊鐘花	吊鐘
同	共	挐
同一行業的人	行家
同伴	拍乸
同住一所房子的鄰居	同屋	同屋主
同學	同學仔	書友
同心協力	拍硬檔
同性戀	基佬
同歸於盡	一鑊熟
同甘共苦	同撈同煲	同煲同撈
同行	行家
同鄉	鄉里	鄉里鬼鬼
名字	名
名片	咭片
名牌手錶	金撈
名牌貨	名牌嘢
名義上	話名
名聲好	馨香
名藝人	大老倌
名銜	title
吐	劏白鶴	嘔	漯	𦧲
吐司	多士
吐甘蔗渣	漯蔗渣
吐痰	放飛劍
吐白沫	嘔白泡
吐血	嘔血
吐飯	漯飯
向下滑	𡄽
向他學	睇住佢頭
向來	不溜
向妻子要錢	𢱕金龜
向後彎腰	拗腰
君達菜	豬乸菜
吝嗇	孤寒	慳濕	荷包湆
吞不下	吞唔落
吞不下那口氣	條氣唔順
吞款	抽水	食水
吞錢	抽水	食水
否則	唔係嘅話
否認前言	反口覆舌
吧	吖嗎	吖嗱	啦嘛	啩	囉	罷啦
吩咐	笛	話低	話落
含羞草	怕醜草
含著眼淚	兩眼濕濕	眼濕濕
吭聲	出聲	開聲
吮	啜
吱	咇
吱出來	咇出嚟
吱聲	出聲
吵	嗌	嘈
吵一場大架	嗌大交
吵個不停	嘈生晒
吵吵嚷嚷	嘈喧巴閉
吵吵鬧鬧	嗌生晒	嘈嘈閉	嘈生晒	墟咁嘈	墟巴嘈閉
吵得要命	嘈到死	鬼殺咁嘈
吵成一片	嗌生晒
吵架	嗌交	嗌霎	嘈交	拗頸	炒大鑊	爭交	爭拗	鬧交
吵死了	嘈到死	鬼殺咁嘈
吵起來	嘈起上嚟
吵醒	嘈醒
吵鬧	嗌	嘈吵
吵鬧不停	嘈嘈閉
吵鬧得很厲害	墟咁嘈	墟巴嘈閉
吸	啜	嗍
吸一口氣	透啖氣
吸一口煙	嗍啖煙
吸塵器	吸塵機
吸奶	啜奶
吸引	引
吸毒	嗍K	揩粉	揩草
吸毒的年輕人	粉仔
吸毒者	道友
吸水	嗍水
吸煙	煲煙	食煙
吸白粉的人	粉友
吸管	飲筒	飲管
吸透	淰
吸進	啜入
吸鐵石	攝石
吸食毒品的場所	粉竇
吸食氯胺酮	嗍K
吸飲	呷
吸鼻涕	嗍鼻
吹了	掟煲	飛咗
吹南風	回南
吹哨子	吹BB	吹雞
吹哨子結束比賽	吹雞完場
吹捧	托	托大腳	笠高帽
吹泡泡	吹波
吹牛	吹水	大話骰	放葫蘆	車大炮
吹牛吹得天花亂墜	車天車地
吹牛皮	放葫蘆
吹肥皂泡	吹番梘泡
吹風機	風筒
吹鬍子瞪眼	吹鬚睩眼
吹鬍子瞪眼睛	吹鬚睩眼
吻	啜嘴	錫
吻一下	錫一啖
吻臉蛋	啜面珠
吻臉頰	錫面珠墩
呀	吖嘛
呆	戇
呆呆的	木口木面
呆在屋裡	屈喺屋企
呆子	戇佬	木嘴	木獨佬	盲毛	茂尼
呆板	木獨	梗板	死估估
呆滯	吽哣	木獨
呆瓜	戇居	粉腸
呆笨	豬兜
呆若木鷄	木木獨獨
呆頭呆腦	一嚿飯噉	壽頭壽腦	木
告別	講拜拜
告得他坐牢	告到佢甩褲
告狀	告	煮米	煮重米
告訴	話……知	話……聽	話畀……知	話畀……聽
告訴…	話…知	話畀…知	話畀…聽	講畀…知	講畀…聽
告訴他	講畀佢知	講畀佢聽
告訴你	話你知	話畀你知	話畀你聽
告訴我	講畀我知	講畀我聽
告辭	走先
呢	嘅	噃
呢大衣	絨褸
呢子上衣	絨衫
呢子褲	絨褲
呢絨	絨
周圍	四便	四邊四便
周轉	走趲
呱呱大叫	劏豬噉嗌
味兒衝	掯
味澀	劫
味道	味	𡃴
味道好極了	好好味
呵	㗾
呵氣	㗾
呸	唓	啋
呸！	啋過你	啋過你把口	啋過你把衰口
呸！大吉大利！	啋過你，大吉利事
呼叫器	call機
呼叫機	BB機
呼吸	透氣
呼天搶地	喊苦喊忽
呼氣	透氣
命不好	命水唔好
命令	柯打
命大	大命
命好	好命
命苦	辛苦命
命運	命水
咀嚼	噍
咂	嗒
咂嘴聲	嗒嗒聲
咂糖果	嗒糖
和	共	同	同埋	夾	挐	與共
和善	腍善
和好	好翻
和好如初	箍煲
和樣品不符	唔對辦
和樣品符合	對辦
和牌	食糊
和聲細氣	好聲好氣
和藹可親	腍善
和麵	搓粉
咕嘟	豁
咕嘟咕嘟地響	豁豁聲
咖啡	啡
咖啡加奶茶	鴛鴦	鴛鴦茶
咖啡廳	咖啡廊
咖啡的污跡	咖啡漬
咖啡色	啡色
咖啡茶	鴛鴦	鴛鴦茶
咖喱魚丸	咖喱魚蛋
咦	噫
咬	噬
咬一口	咬一啖	噬一啖
咬下去都是肉	啖啖肉
咬不動	咬唔入
咬人	噬人
咬緊牙關	咬實牙關
咱們	我哋
咳嗽	咳
哀求	噅
品嚐	嗒
品種	停
品茶	歎茶
哄	冧	嗿
哄人	嗿人
哄人上當	嗿人入局
哄人說出真相	嗿人爆料
哄人高兴	嗿人歡喜
哄他開心	嗿佢開心
哄她開心	嗿佢開心
哄嬰兒	藹
哄小孩	嗿細蚊仔	笠細路仔
哄騙	嗿	棍騙
哆哆嗦嗦	揗揗震
哆嗦	揗	震
哇	嘩
哈	㗾
哈一口氣	㗾一啖氣
哈欠	喊路
哈氣	㗾
哈蜊	蜆
哎呀	哎吔
哎喲	哎吔
員工	伙記
哥	亞哥
哥兒們	大佬
哥哥	亞哥	大佬	阿哥
哦	噫
哨子	BB	銀雞	雞
哩	咪
哪	邊
哪一個	邊個
哪一天	邊日
哪一年	邊一年
哪一次	邊次
哪一邊	邊邊
哪些	邊啲
哪個	邊個
哪兒止	點止
哪兒知道	點知
哪有	邊有
哪種	邊種
哪能…	…都有嘅
哪裡	乜嘢話	乜話	乜說話	唔係噉話，你過獎喇	好話	邊	邊度	邊處
哪裡哪裡	乜話	乜說話	唔係噉話	好話喇好話喇	好話好話	邊處係呢
哪裡是對手	唔係手腳
哪裡有	邊有
哪裡知道	點知
哪邊	邊邊
哭	喊
哭不出來	喊唔出
哭個不停	喊苦喊忽
哭哭啼啼	喊苦喊忽
哭喊著要死要活	嗌生嗌死
哭喪著臉	喊喊口	喊噉口	揦口揦面	揦埋口面	苦口苦面	苦瓜乾噉口面	苦瓜噉口面	苦瓜噉嘅面	苦瓜噉面	苦瓜面
哭笑不得	嬲好定笑好
哭鬧	囉囉攣	囉攣
哭鼻子	流馬尿
哮喘	扯哈	扯蝦	擝哈
哼歌聲	唱口
唉聲歎氣	唉唉聲	嚡嚡聲
唐人街	華埠
售罄	賣晒
售貨員	sales	賣貨員
唱京劇	做京戲
唱卡拉OK	唱K
唱片	唱碟	大碟	片
唱片店	唱片舖
唱片節目播音員	唱片騎師
唱高調	口響
唷	噫
唸中學	讀中學
唸大學	入大學	讀大學
唸書	讀書
唾沫星子	口水溦	口水花
啃	噒	鋤
啃書	咪	咪書
啃書本	鋤書
啃橄欖核	噒欖核
啄咬	啄
啄食	啄
商人	孖展
商品緊俏	渴市
商埠	埠
商店	商舖	舖	舖頭
商標	嘜	嘜頭
商談	斟
商議	斟盤
商量	斟
商量一下	斟吓
商量商量	斟吓
啊	個喎	個噃	個囉	吓	吖	呀	囉
問倒	問起
問話	落口供
問題	阻滯
啜	呷
啞口無言	O咀	O晒咀	擘大個口得個窿	擘大口得個窿
啞巴	啞佬
啞巴說聾子聽	雞同鴨講
啟航	開身
啟輝器	士撻膽
啤酒	番鬼佬涼茶	老番涼茶	鬼佬涼茶
啤酒瓶	啤酒樽
啤酒肚	call機肉	士啤肽
啥事兒	乜東東
啥玩意兒	乜東東
啦	個喎	個噃	個囉	個囉噃	囉	羅
啼哭	囉攣
啼笑皆非	嬲好定笑好
喂！	哈佬
喃喃	吟
善始善終	好頭好尾
善後	執手尾	手尾
善忘	水過鴨背
善於說話	好傾好講
善會	善堂
善良	馴品
善良的人	腍佛
善解人意	話頭醒尾
喉片	喉糖
喉結	喉核	喉欖
喊	嗌
喊人	嗌人
喊倒好兒	㗾
喊叫	嗌
喊名字	嗌名
喊救命	嗌救命
喋喋不休	口噏噏	宜咿哦哦
喏	嗱
喔	喎	噃
喘一口氣	透啖氣
喘一口氣一會兒再幹	唞順條氣	唞順氣
喘不過氣	扯晒蝦	氣都透唔到	透唔到氣
喘氣	嗍氣	透氣
喜不喜歡	鍾唔鍾意
喜帖	紅色炸彈
喜愛	歡喜
喜歡	中意	冧	歡喜	鍾意
喜餅	嫁女餅
喝	呷	豁	飲
喝一杯	飲杯
喝一杯吧	飲翻杯喇
喝一杯啤酒	啤一啤
喝倒採	㗾
喝口水	飲啖水
喝口茶	飲啖茶
喝啤酒	隊啤
喝多了	飲大咗兩杯
喝得滿臉通紅	飲到面紅紅
喝得面紅耳赤	飲到面紅紅
喝水	飲水
喝粥	食粥
喝茶	歎茶	飲茶
喝西北風	食西北風
喝酒	劈酒	隊酒	飲傻仔水	飲嘢	飲酒
喝醉	飲醉
喝醉了	飲大咗	飲大咗兩杯	飲醉咗	飲醉酒
喝飲料	飲嘢
喧嘩	嘈吵
喧賓奪主	妹仔大過主人婆
喩錢財從多方面進來	豬籠入水
喪事	白事
喬治亞	格魯吉亞
單人床	獨睡
單人旁	單徛人	徛人邊
單元	單位
單口相聲	戙篤笑
單口相聲表演	戙篤笑騷
單單	淨
單打獨鬥	隻抽	隻抽隻
單挑	隻抽
單相思	單思
單眼皮	單眼簷
單立人兒	企人邊
單腳跳	趷跛跛
單身漢	單身寡仔	單身寡佬	寡佬	王老五
嗆	濁
嗆著	濁親	鯁親
嗆著了	濁親
嗍風機	吸塵機
嗎	㗎啦	吖嗎	咩	嘅	衙
嗓子	喉嚨	聲喉
嗓子嘶啞	喉嚨拆晒	聲喉坼
嗓子沙啞	喉嚨拆晒	喉沙	聲喉坼	聲喉沙
嗓子疼	喉嚨痛
嗓子破	聲喉坼
嗓門	聲喉
嗜好深	爛癮
嗜賭	爛賭
嗜賭的人	爛賭二
嗨！	哈佬
嗩吶	啲咑
嗬	噫
嘀嗒水	水渧渧
嘈雜	嘈
嘍	個囉噃
嘔吐	劏白鶴	嘔
嘗到甜頭	飲頭啖湯
嘛	吖嘛	啦嘛
嘟	𡁯
嘟嘴	𡁯	𡁯長個嘴
嘟嚕	揪	纊掕	藭
嘟著嘴	𡁯起個嘴
嘬	啜
嘮叨	口多多	吟	吟沉	發牙痕	譖	譖氣	譖趙	譖醉	長氣
嘮叨不休的人	長氣袋
嘮叨個不停	吟嚟吟去
嘮嘮叨叨	吟吟沉沉
嘮嘮叨叨沒個完	口水多過茶
嘰嘰咕咕	嘰哩咕嚕
嘴	口
嘴嚴	口密	密實
嘴巴	口	嘴
嘴巴不嚴	口疏
嘴巴厲害	牙尖嘴利
嘴巴嚴	口密	密實
嘴巴子不肯吃虧	牙尖嘴利
嘴巴式	口水佬
嘴巴癢癢	口痕
嘴快	口快	口快快	口爽	口疏
嘴硬	口硬	死撐
嘴脣	口脣
嘴角對人	嘴喵喵
嘴饞	為食	爛食
嘴饞的小孩	為食仔
嘶	啡
嘶嘶響	啡啡聲
嘻哈地笑	畸卡咁笑	笑到畸畸聲
嘻嘻哈哈	大癲大廢	畸畸卡卡
噁心	作嘔	反胃	嘔心	核突	肉酸
噎	鯁	鯁頸
噎死	鯁死
噎著	濁親	鯁親
噎著了	鯁親
噓	㗾
噔噔地跑	𨂽𨂽趯
噘	𡁯
噘嘴	𡁯	𡁯長個嘴
噘著嘴	𡁯起個嘴
器物	架罉
噪鬧	墟冚
噱頭	卓頭
噴	標	瀄
噴出	標出
噴出來	標出嚟
噴出去	標出去
噴嚏	乞嗤
噴射	啡	瀄
噴水	啡水
噴頭	花灑
噴飯	漯飯
嚇一跳	嚇親
嚇了一跳	嚇一驚
嚇了個半死	嚇餐死
嚇人	得人怕	得人驚
嚇倒了	嚇窒
嚇呆了	嚇窒
嚇唬	嚇
嚇壞了	嚇窒
嚇得他臉色都變了	失驚忘神	失驚無神
嚇得屁滾尿流	驚到標尿
嚇得發抖	有得震無得瞓
嚇得直冒汗	嚇到標汗
嚇得直打哆嗦	驚到揗揗震
嚇得臉色發白	驚到面青
嚇得臉色蒼白	驚到面青
嚇得說不出話來	嚇窒	驚到唔出得聲
嚇我一跳	嚇我一驚
嚇死了	嚇餐死
嚇著	嚇親
嚐一下味道	試味	試味道
嚐味	嗒	試味	試味道
嚥	鯁
嚥不下	吞唔落	鯁唔落
嚥氣了	瓜直
嚴密	冚
嚴實	口密	密實
嚴重	大單	大陣仗	緊要
嚷	嗌
嚼	噍
嚼不動	咬唔入	噍唔喐
嚼不爛	韌
嚼勁	噍頭
嚼口香糖	噍香口膠
嚼泡泡糖	噍吹波膠
嚼爛	噍爛
嚼碎	噍爛
囂張	串	塵	白霍
囉哩囉唆	宜咿哦哦
囉唆	發牙痕	譖	譖氣	譖趙	譖醉	長氣
囉嗦	口水多過茶	吟
囉囉唆唆	宜咿哦哦
囚徒	監躉
囚犯	監躉
囚禁	韞
四下裡	四便
四分之一	骨
四分之三	三個骨
四十五分鍾	九個字
四十五分鐘	三個骨
四十分鍾	八個字
四十塊	四十蚊
四十多歲	四張幾
四千元左右	四千蚊度
四千塊左右	四千蚊度
四周	周圍	四便	四周圍	四圍	四邊四便
四周張揚	周圍唱
四四方方	四四正正
四方臉	國字口面
四眼兒	四眼仔	四眼佬	四眼妹
四眼田雞	四眼仔	四眼佬	四眼妹
四處	周圍	四周圍	四圍
四處奔走	頻頻撲撲
四面	四便
回	仗	翻	返
回不了頭	翻唔到轉頭
回不到	翻唔到去
回來	翻嚟	返嚟
回公司	翻公司
回到	翻到
回去	翻去
回去不了	翻唔到去
回味無窮	食過翻尋味
回家	翻企	翻屋企
回座位	埋位
回形針	萬字夾
回想	諗翻轉頭
回憶	諗翻	諗翻轉頭
回房間	翻房
回房間睡覺	返房瞓
回扣	抽水	食水
回扣拿得太多	食水太深
回暖	回南
回暖天氣	回南天
回答得很迅速	漯飯應
回過頭來	戾轉頭
回過頭來想一想	諗翻轉頭
回鄉下	翻鄉下
回電話	打翻電話	覆機	覆電話
回頭	擰轉頭	翻轉頭	轉頭
回頭再	轉頭
回頭再來	翻轉頭再嚟	轉頭嚟過
回頭看	望翻轉頭
回頭見	轉頭見	遲啲再見
囟腦門兒	腦筍
囟門	腦筍
因地制宜	睇餸食飯
因為	事關	皆因
因瘀血而發黑	瘀黑
囤貨	躉貨
困惑	一頭霧水
固執	倔	唔化	板頸	梗頸	牛頸	盟塞	硬頸
固定衣櫃	入牆櫃
固態硬盤	固態硬碟
圈	緙	韞
圈兒	囡
圈內人	圈中人
圈圈叉叉	井字過三關	過三關
圈套	局
國事訪問	官式訪問
圍	攬
圍兜	口水肩
圍嘴	口水肩
圍嘴兒	口水肩
圍圍巾	攬頸巾
圍巾	頸巾
園丁	花王
圓了心願	還咗心願
圓圓	圓碌碌
圓圓的	圓碌碌
圓夢	解夢
圓心願	還心願
圓溜溜的	圓碌碌
圓滾滾的	圓碌碌
圓珠筆	原子筆
圓白菜	椰菜
圖	貪
圖口舌之快	貪口爽
圖好玩兒	貪得意
圖紙	圖則
圖釘	撳釘
團團轉	氹氹轉
團魚	水魚
土	泥
土包子	土佬	大鄉里	鄉下仔	鄉下佬	鄉下妹	鄉下婆
土司	多士
土地公	土地
土地神	社公
土埂	壆
土山	泥山
土氣	老土
土牆	泥牆
土特產	手信
土豆	薯	薯仔
土豆泥	薯蓉
土豆片	薯片
在	响	喺	響
在…	响…度	喺…度
在…之間	介乎
在世	在生
在乎	志在	著緊
在光天化日之下	白日流流
在同一個大院裡住	同屋共主
在同一屋簷下共同生活	同屋共主
在哪裡	响邊度	喺邊度
在地上打滾	碌地	碌地沙
在娘家吃閒飯	攝灶罅
在客廳睡覺	做廳長
在客廳裡睡覺的人	廳長
在客廳裡過夜的人	廳長
在客廳過夜	做廳長
在家	傍家	响屋企	喺企	喺屋企
在家裡無所事事	喺屋企迆
在家裡閒來無事	喺屋企迆
在工廠做工	打工廠工
在店內吃	堂食
在想事兒	諗緊嘢
在意	計帶
在手	揸手
在行	熟行
在街道旁邊擺賣	擺街邊
在裡面	响入面
在賭馬中輸錢	鋪草皮
在路邊的小吃攤檔進食	踎大牌檔
在近處	就近
在這裡	响度	响處	喺度	喺處
在遠處	離遠
在那裡	响度	响處	喺度	喺處
地上	地下
地下商場	地庫商場	地牢商場
地下妓院	架步
地下室	地庫	地牢
地下賭場	大檔	賭檔
地不怕	自細嚇大
地位低	細粒	細細粒
地兒	埞
地函	地幔
地址	地埗
地基	地腳
地方	地埗	埞	埞方	忽	處
地方不夠	唔夠埞方
地方惡霸	地頭蟲
地方窄而不整齊	罨汁
地板磚	階磚
地毯	地氊
地理	geogra
地瓜	番薯
地產大亨	大富翁
地產經紀	物業代理
地痞	地踎	陀地
地皮	樓花
地盤	地頭
地磚	階磚
地窖	地牢
地道	正斗
地道貨	正斗嘢	正斗貨
地頭蛇	地頭蟲
均勻	勻巡
坍塌	冧
坐一下	坐陣
坐一會兒	坐陣
坐下	坐低
坐不住	喐喐貢	坐唔定
坐不定	扎扎跳	跳扎扎	跳跳扎
坐不穩	坐唔正	坐唔穩
坐享清福	上岸
坐吃山空	坐食山崩
坐在一塊兒	坐埋一齊
坐在一起	坐埋一齊
坐在地上	坐喺地下
坐在那裡不動	成嚿佛	成尊佛噉
坐墊	椅墊	椅薦
坐好	坐定定	坐正
坐好了	坐定
坐式廁所	坐廁
坐得好好的	坐定定
坐月子	坐月
坐標紙	格仔紙
坐滿了人	爆晒棚
坐牢	坐監	扽監	踎監	食皇家飯
坐穩	坐定定	坐正
坐船遊覽	遊船河
坐起來	坐企身	坐起身
坐車	搭車
坐車不買票	搭霸王車
坐靠牆的座位	坐卡位
坐麵包車	搭小巴
坑	氹
坑人	放貴利	裝彈弓
坡幣	坡紙
坦尚尼亞	坦桑尼亞
坦米爾	泰米爾
坦米爾語	泰米爾語
垂下	耷	耷低
垂下來	耷低
垂涎三尺	口水嗲嗲渧	流口水	流晒口水
垂直豎立著	戙企	戙篤企
垂頭	耷低頭
垂頭喪氣	一隻屐	耷頭耷腦
垂頭喪氣地	死死氣
垂頭喪氣沒精打採	頭耷耷眼濕濕
垃圾滑道	垃圾槽
垛	㨆
垮台	冧檔
埋	壅
埋怨	怨	怨唱
埋頭幹	鋤
城市	城
城市疾走	飛躍道
執拗	板頸	梗頸	牛頸
執照	拉臣	牌
執筆忘字	揸筆忘字
執著	盟塞
執行長	行政總裁
培土	壅泥
培根	煙肉
基堤	塘壆	護壆層
基本工資	底薪
堂	疏堂
堂兄弟	疏堂兄弟
堂哥	堂亞哥
堂妹	堂細妹
堂姐	堂家姐
堂姐妹	疏堂姐妹
堂弟	堂細佬
堂皇	架勢
堅固	實淨	硬淨	穩陣
堅固耐用	實淨
堅決	一於	實牙實齒
堅決不	一於唔
堅決不答應	一於唔制
堅決不讓他去	一於唔畀佢去
堅決否認	死口唔認
堅韌不拔	捱得
堆	㨆
堆房	士多房
堆疊	㨆
堤壩	基圍	壆
堪輿家	風水佬	風水生
報夢	託夢
報攤	報紙檔
報攤兒	報紙檔
報紙攤	報紙檔
報販	報紙佬
報銷	claim翻	出公數
報銷了	瓜柴
場面一時大亂	倒瀉籮蟹
場面混亂	倒瀉籮蟹
堵	埲
堵塞	擠塞	盟籠
堵車	塞車
塊	嚿	忽	笪	蚊	銀錢
塊兒大	大嚿
塊兒小	細嚿
塊錢	皮	蚊雞	銀錢
塊頭大	大嚿	大隻
塌方	冧山泥	山泥傾瀉
塑料	塑膠	膠
塑料凳子	膠凳
塑料刀	膠刀
塑料刀子	膠刀
塑料叉子	膠叉
塑料喉管	膠喉
塑料套	膠套
塑料娃娃	膠公仔
塑料拖鞋	膠拖
塑料杯	膠杯
塑料桌布	膠枱布
塑料桶	塑膠桶	膠桶
塑料椅子	膠凳
塑料瓶	膠樽
塑料盒	膠盒
塑料盒子	膠盒
塑料眼鏡	膠眼鏡
塑料碟	膠碟
塑料碟子	膠碟
塑料管	膠通
塑料花	膠花
塑料袋	膠袋
塑料袋兒	膠套
塑料袋子	膠套
塑膠	塑料	膠
塑膠叉	膠叉
塑膠桶	膠桶
塑膠水管	膠喉
塑膠瓶	膠樽
塑膠盒子	膠盒
塑膠眼鏡	膠眼鏡
塑膠袋	膠袋
塔	撻
塔吉克斯坦	塔吉克
塗	扠
塗上口紅	搽口脣膏	搽脣膏
塗口紅	搽口脣膏	搽脣膏
塞	扤	掙	攝	枳
塞不下	掙唔落
塞入	攝
塞子	枳
塞滿了	掙滿晒
塞牙縫	攝牙罅	黐牙
塞進	枳	枳入
塞進來	攝入嚟
塞進去	攝入去
填	枳
填充玩具	毛公仔
填肚子	醫肚
填飽肚子	醫肚
塵土	塵	泥塵	煙塵
塵土飛揚	煙塵滾滾
塵埃	塵
墊	攝	薦
墊子	薦
墊布	枱薦	餐薦
墊桌腿	薦枱腳
墊肩	假膊
墊褥	床薦
墊起來	薦起
墊高	攝高
墊高一點	薦高
墜	惰	舂
墜下	惰落
墜下來	惰落嚟	舂落嚟
墜下去	舂落去
增光	攞彩
墨汁	墨
墨鏡	太陽眼鏡	黑超
墩兒	躉
墩子	躉
壁虎	簷蛇	鹽蛇
壓	扤	責	轆
壓低別人以抬高自己	踩低人哋，抬高自己
壓傷	責親
壓力鍋	壓力煲	高速煲
壓尾	包尾
壓得住場面的	殺食
壓抑著	收收埋埋
壓歲	責年
壓歲錢	利是	利是錢	責年
壓死	責死
壓緊	扤實
壓緊一點	責實啲
壓著	責住
壓隊	包尾
壞	奸	弊	衰
壞主意	橫丫腸
壞了	堝	壞咗	弊	弊傢伙	弊喇	爛咗	神	神咗
壞事	衰嘢
壞人	奸角	衰人
壞傢伙	死佬	衰人	衰公	衰嘢	衰神	衰鬼	衰鬼豆
壞兆頭	唔好意頭
壞女人	衰婆
壞女孩	死僆妹	衰女	衰女包
壞朋友	損友	豬朋狗友
壞東西	衰鬼豆
壞脾氣	唔好老脾
壞處	弊處
壞蛋	死佬
壞透了	真係衰嘅啫	衰到唔使恨
壞點子	屎坑橋	屎坑計
壠	壆
壽斑	壽癦
壽星	壽星公
夏天	天時熱	熱天
夕陽西下	太陽落山
外來的	來路
外公	公公
外出	出街	出門	出門口	落街
外出流連	we𠿭𠿭	出嚟蒲	𠿭
外包伙食	包伙食
外國人	番鬼佬	紅鬚綠眼	老番	西人	鬼佬
外國商埠	埠頭
外國太太	鬼婆
外國女人	鬼婆
外國女孩	番鬼妹	鬼妹
外國姑娘	番鬼妹	鬼妹
外國婦女	番鬼婆	鬼婆
外國小孩	番鬼仔	鬼仔
外國少女	番鬼妹	鬼妹
外國影片	西片
外國男孩	番鬼仔	鬼仔
外國的	鹹水
外國的月亮比較圓	隔籬飯香
外國貨	來路貨
外國電影	西片
外地人	外江佬	外省佬
外地貨	外江貨
外套	短褸
外帶	外賣
外幣	西紙
外形優美	有型有款
外文	西文	雞腸
外甥	姨甥
外甥女兒	姨甥	姨甥女
外省	外江
外省人	外江佬	外省佬	撈佬	撈鬆
外省來的女孩子	撈女	撈妹
外省來的男孩子	撈仔
外省的	外江	撈
外省的貨品	外江貨
外祖母	亞婆	外婆	婆婆	阿婆
外祖父	亞公	公公	外公	阿公
外號	朵	花名
外行	唔熟行
外衣	短褸
外表突出	有型有款
外語	番話
外賬、外債	街數
外遊	出埠
外邊	出便	出面	外出	開便
外面	出便	出面	外便	外出	外底	開便
外頭	出面	開便
多	多多
多一事不如少一事	少件得件
多一些	多少少
多一點	多啲	多少少
多久	幾耐
多了	多多聲
多出一點點	多少少
多半兒	多數
多嘴	口多多	口花花	多口	巴揸	發牙痕
多嘴多舌	口多多
多多少少	唔多唔少
多多的	多羅羅
多大	幾大
多容易	容乜易
多少	幾	幾多
多少錢	幾多錢	幾錢	點賣
多手多腳	手多多
多有承惠	多得晒
多梗阻	濕滯
多的是	多多聲
多睡一會兒	瞓多陣
多虧	多得
多說一句話	多句嘴
多說話	勞氣
多遠	幾遠
多雨時節	雨水天
多麼	幾	幾咁
夜宵	宵夜	消夜
夜晚	晚頭夜	晚頭黑	黑後
夜消兒	宵夜
夜班	夜更
夜盲症	雞盲
夜裡	夜晚黑	晚頭夜	晚頭黑	黑後
夜貓子	夜貓	夜遊神	夜鬼
夠	夠數	夠皮	擙
夠…	夠晒…
夠下來	擙落嚟
夠不到	擙唔到
夠不著	擙唔到
夠了	夠喇
夠了有餘	夠咗有突
夠你學的	有排你學
夠你忙的	有排你做
夠你等的	有排你等
夠戧	交關	咧氣	夠算	死死吓
夠排場	架勢
夠朋友	夠老友
夠本	夠皮
夠本兒	值晒票價
夠格	夠quali
夠等的	禁等
夠等的了	有排等
夠資格	夠班
夢遊	遊魂
夥計	企堂
大	大個
大一點	大少少
大一點兒	大少少
大不了	至多	至多唔係
大不了…罷了	至多
大主顧	大客仔
大事不好	大件事
大人	大人大姐
大人物	大粒佬	大粒嘢	大粒癦
大伯子	大伯
大便	出恭	屙屎	開大
大便處	屎坑
大個兒	大嚿	大隻佬
大前天	大前日
大力吹噓	力谷
大功告成	攪掂
大半輩子	成世人
大叔	亞叔
大口	大大啖
大口喘氣	大力透氣
大口地	大大啖
大叫	大嗌
大吃大喝	大使大食	大食	大飲大食
大吃特吃	擦餐勁	擦餐懵	擦餐飽
大吉大利	大吉利事
大吵一架	嗌大交
大吵大鬧	炒大鑊	鬼殺咁嘈
大哥	亞哥	大佬
大哭	喊到拆晒天
大喊	大嗌
大嗓門	嘮嘈	大聲公
大嗓門兒	大聲公
大型演出	大騷
大場面	大蛇屙尿	大陣仗
大塊兒	大隻佬
大塊頭	大嚿
大多	多數
大大咧咧	大癲大廢
大大撈一筆	盤滿缽滿
大大撈了一筆	撈到盤滿缽滿
大大賺了一筆	賺到盤滿缽滿
大姐	家姐
大姑子	姑奶
大姨	大姨媽	姨媽
大姨兒	大姨媽
大姨子	大姨
大媽	伯娘
大嫂	亞嫂
大官	大粒癦
大少爺	大少	太子爺
大年初一的	初一流流	年初一流流
大律師	大狀
大後天	大後日
大怒	食咗火藥
大意	大懵	烏龍
大手大脚地花錢	洗腳唔抹腳
大把花錢	大使	大使大食
大拇指	手指公
大拿大主	自把自為
大排長龍	打蛇餅	水蛇春咁長
大搖大擺	大模斯樣
大方地拿去送人	派街坊
大晴天兒	好天
大概	多數	約莫
大模大樣	大模斯樣
大步跨過	大步擸過
大清早的	大清早流流	晨早流流
大減價	大出血
大熊貓	熊貓
大男人的	男人老狗
大發雷霆	發啷厲	發晒老脾	發狼戾
大白菜	娃娃菜	津白	紹菜	肇菜	黃芽白
大的欺負小的	大石責死蟹
大眼鯛	大眼雞
大禍臨頭	死人兼冧屋
大粒兒	大粒
大約	約莫
大繩子	索
大缸	甕缸
大老二	鋤大弟
大老婆	大婆
大老闆	亞一	波士
大耍嘴皮子	口水多過茶
大耳朵	兜風耳
大聲	嘮嘈
大聲叫喊	嗌生晒
大聲喘氣	大力透氣	透大氣
大聲嚷嚷	鬼殺咁嘈
大肚子	啤酒肚	肚腩	肥肚腩
大肚皮	call機肉	士啤肽	大肚腩	肥肚腩
大脖子	大頸泡
大腳趾	腳趾公
大腿	大髀	髀
大膽	沙膽	膽生毛
大舅子	大舅
大蜘蛛	蠄蟧
大蝦塊兒	蝦轆
大街上	大街大巷
大衣	大褸	褸
大衣式連衣裙	褸裙
大解	開大
大象	大笨象
大賭	搏殺
大路貨	行貨
大送人情	賣大包
大過年的	新年流流
大部分	多數
大量	大單
大量資金積壓	水浸
大鍋熬	一鑊熟
大鍋飯	大鑊飯
大長見識	開眼界
大門	大閘	門
大降價	大出血
大陸姑娘	大陸妹
大陸青年	大陸仔
大雨如注	落狗屎
大雨滂沱	落狗屎
大頭菜的一種	沖菜
大頭貼	貼紙相
大顆	大粒
大風雨	橫風橫雨
大飯店	酒家	酒樓
大飯館	酒家	酒樓
大體上	略略
大鬍子	鬍鬚佬	鬍鬚公
大鹽	生鹽
天	日
天上下刀子	老虎蟹
天上不會掉餡兒餅	邊有咁大隻蛤乸隨街跳
天不怕	自細嚇大
天亮	天光
天台	天棚
天塌下來	老虎蟹
天塌下來有高個子頂著	天跌落嚟當被冚
天塌地陷	老虎蟹
天壤之別	差天共地	蚊髀共牛髀	蚊髀同牛髀
天天	日日
天快黑	諵光黑
天旱	天時旱
天書	雞腸
天橋把式	大隻講
天殺	天收
天殺的	天收佢
天氣	天口	天時
天氣不好	天時唔好
天氣冷	天口凍	天時凍
天氣反常	天時唔好
天氣好	好天
天氣寒冷	天口凍	天時凍
天氣晴	好天
天氣炎熱	天時暑熱
天氣熱	天口㷫	天口熱
天津白菜	津白
天淵之別	差天共地
天花亂墜	天花龍鳳
太	得滯
太…	…過頭
太不像話了	太冇解喇
太久了	耐過頭
太便宜	抵到爛
太便宜了	抵到爛
太值	抵到爛
太值了	抵到爛
太值得了	抵到爛
太冷	太凍
太吵了	嘈得滯
太多	多過頭
太多了	多過籠
太大了	大得滯
太太	師奶
太好了	啱晒
太妨礙你們了	打攪晒
太姥姥	外太婆
太容易	容乜易
太容易辦了	易過借火
太小了	細過頭
太巧了	好蹺
太打攪了	打攪晒	騷擾晒
太晚	蚊瞓	蚊都瞓
太晚了	夜過頭	蚊瞓	蚊都瞓	蛇都死
太澀	揦脷
太熟了	熟得滯
太熱了	熱過頭
太甜	甜椰椰
太甜了	甜得滯	甜過頭
太空梭	穿梭機
太老爷	外太公
太胖了	肥過頭
太謝謝了	多得晒
太貴了	貴過頭
太辣	揦脷
太過	得滯
太過糊塗	懵盛盛
太遠了	遠得滯
太遲	蚊瞓	蚊都瞓
太遲了	蚊瞓	蚊都瞓	蛇都死
太長了	長過頭
太陽	日頭	熱頭
太陽下山	太陽落山
太陽眼鏡	超
太陽穴	魂精
太陽鏡	黑超
太陽雨	白撞雨
太飽了	飽得滯
太鹹	揦脷	鹹赧赧
夫人	師奶
夫妻	兩公婆
夫妻倆	兩公婆
央求	噅
失信	甩底
失去	跌失
失去了感情	心淡
失去聯絡	蕩失
失寫症	揸筆忘字
失戀	甩拖
失敗	堝	撞板	肥佬
失敗了	衰咗
失敗了還硬撐著	跌低揦翻拃沙	跌落地都要揦翻拃沙
失業	踎墩
失禮	騎呢
失禮了	失禮
失竊	爆竊
失約	放飛機	甩底	甩拖
失誤	差遲
失讀症	讀寫困難
失面子	失禮
夾	挾
夾住	挾親
夾克	jacket	飛機恤
夾到	挾親
夾子	夾
夾菜	挾餸
夾著	夾住
夾衣	夾衲
夾道	冷巷
奇妙	蹺妙
奇形怪狀	騎呢
奇怪	出奇	奇	怪	鬼馬
奇特	騎呢
奇瓦瓦小狗	芝娃娃
奈何	吹脹
奈何不了	吹唔脹	咬唔入
奈何不了他	吹佢唔脹	咬佢唔入	攪佢唔掂
奈何不得	冇奈何
奉承	笠高帽
奉承上司	托老闆
奉承討好	托大腳
奎寧丸	見連丸
契約	契
奔波	撲	走趯	頻撲
套	笠	脫
套得很嚴實	笠實	笠實晒	笠緊
套著	笠住
套著頭	笠頭
套衫	過頭冷衫
套袖	手袖
套購東西	擸嘢
套近乎	認親認戚	讕熟落
套間	單位
套頭	笠頭	過頭笠
套頭上衣	T恤	笠衫	笠記	過頭笠
套頭毛衣	過頭冷衫
套頭汗衫	T恤	笠衫	笠記	過頭笠
套頭的	笠頭	過頭笠
套頭穿的	笠頭
套頭衫	笠衫
奠基	打樁
奧綸	柯崙
奪目	搶鏡	醒神
女主人	主人婆
女二房東	包租婆
女人	婆乸
女傭	妹仔
女傭人	媽姐
女儐相	姊妹
女兒	亞女	囡囡	女	女女
女兒家	女仔之家
女同性戀	基女
女嬰兒	啤啤女	臊蝦女
女孩	女	女仔	女包
女孩兒	女仔	後生女	臊蝦女
女孩子	僆女	僆妹	僆妹仔	囡囡	女仔	細路女
女孩子家	女仔之家	女仔流流
女學生	學生妹
女工人	打工妹
女強人	叻女
女性化	乸型
女流氓	串女	撈女	爛女
女老師	miss
女警察	差婆
女賊	撈女
女騙子	撈女
奶	[姩]	波
奶奶	亞奶	亞嫲	嫲	嫲嫲
奶油	忌廉	牛油
奶油甜甜圈	奶油冬甩
奶油維夫餅乾	忌廉威化餅
奶油蘇打	忌廉梳打
奶油蘇打汽水	忌廉梳打
奶油餅	奶油戟
奶油餅乾	忌廉餅乾
奶瓶	奶樽
奶酪	芝士
奶頭	𢆡頭
奸細	二五仔	灰佬
奸詐	奸	奸狡
她	佢
她們	佢哋
她們的	佢哋嘅
她們自己	佢哋自己
她們自己的	佢哋自己嘅
她的	佢嘅
她的為人	佢個人
她自己	佢自己
她自己的	佢自己嘅
好	勁	正斗	盞	盞鬼	筍	靚
好一點	好啲
好不到哪裡去	唔好得去邊
好不好	好唔好
好不容易	幾難
好不容易才	幾難先至
好主意	好橋	好計仔	絕世好橋	絕橋
好久不見	好耐冇見
好了一點兒	好少少
好人一個	好人好姐
好傳話	口疏
好像	好似
好像…一樣	好似…噉
好像是	好似係
好像真有其事	似層層
好價錢	筍價
好兆頭	好意頭
好出風頭的人	白霍友
好動	反斗
好勝	唔衰得
好友	friend過打band
好口才	好口碼
好吃	好味	好喫	好食
好吃但對身不益	利口唔利腹
好吃又便宜	抵食
好吃懶做	大食懶	好食懶飛
好吧	好呀
好味道	惹味
好商量	好易話為	好相與	好話為	易話為
好喝酒	爛酒
好在	勝在
好壞	三衰六旺
好天兒	好天
好天氣	好天時
好奇	貪得意
好好兒的	好地地
好好想一想	攝高枕頭	薦高枕頭
好好想想	諗真	諗真啲
好好的	好地地
好好的人	好人好姐
好孩子	好仔
好巧	好蹺
好很多	好好多
好得多	好好多
好心不得好報	好心著雷劈
好心反被當惡意	好心著雷劈
好打扮	姿整
好朋友	friend過打band
好東西	堅料	正嘢	盞嘢	筍嘢	筍貨	靚嘢
好極了	冇得彈	冇得頂	好到冇朋友
好樣的	叻仔
好歹	話晒
好湯	靚湯
好玩	盞鬼
好球	好波	靚波
好的	OK
好的！	好吖！
好看	型	好樣	好睇	有型	有睇頭	禁睇	靚
好睡	瞓得
好端端	好地地
好端端的	好地地
好笑	攪笑
好聽	啱聽	禁聽
好聽的歌	靚歌
好脾氣	好老脾
好色	爛滾	生雞	鹹濕
好色之徒	鹹濕佬
好色的男人	生雞	生雞精	雞蟲
好萊塢	荷里活
好處	著數	頭啖湯
好言好語	好聲好氣
好說	好易話為	易話為
好貨	筍嘢	筍貨	靚嘢	靚貨
好貨不便宜	靚嘢唔平
好賭	爛賭
好賴	假假哋
好賴也是	假假哋都係
好賴還是	假假哋都係
好走	好行
好起來	好翻
好車	靚車
好轉	好翻
好辦	好易話為	好話為	易做	易話為
好辦法	好橋
好青年	好仔
好鬥	爛打
好鬥者	打仔
好鬧	反斗
好點了	好少少
如今	今時今日
如何是好	點呢	點算好
如果	若果	若然	若然之
如此等等	乜乜物物
如此算來	計翻條數	計落
如法炮製	照板煮碗	照板煮糊
如膠似漆	糖黐豆
妄想	夜啲啦	開胃
妄自菲薄	低威
妓女	企街	撈女	雞	鳳	鳳姐
妓女居處	鳳樓
妖艷	鬼火咁靚
妙策	好橋	絕世好橋	絕橋
妙計	好橋	橋	絕世好橋	絕橋
妥當	妥	掂	盞
妨礙	亞吱亞咗	阻
妨礙著	阻住
妹妹	亞妹	妹	細妹	阿妹
妻子	女人	老婆	黃面婆
姊妹花	雙妹嘜
始末	頭尾
始發站	總站
姐	…姐
姐妹	姊妹
姐妹倆	兩姊妹
姐姐	家姐
姑兒	姑姐
姑姑	亞姑	姑姐	姑媽
姑娘	僆女	僆妹	女仔	姐姐仔	後生女
姑娘家	女仔之家
姑母	亞姑	姑姐	姑媽
姑父	姑丈
委曲求全	馬死落地行
姥姥	亞婆	婆婆
姨兒	姨媽
姨太太	二奶
姨夫	姨丈
姨姨	亞姨
姨姪	姨甥
姨姪女	姨甥	姨甥女
姨母	亞姨	姨	姨姨	姨媽	阿姨
姨父	姨丈
姪兒	姪	姪仔
姪媳婦	姪心抱
姪子	姪	姪仔
姿勢	甫士
姿勢不正	歪身歪勢
威而鋼	偉哥
威靈頓	惠靈頓
威風	姣氣	威水	架勢
威風八面	威水
娃娃車	褓姆車
娘們	婆乸
娘兒倆	兩仔乸
娘娘腔	乸型	講嘢好乸型
娘家	外家
娛樂場所	蒲點	𠿭場
娶媳婦	娶心抱	新抱茶
娶有錢的寡婦	淘古井
娼妓	企街
婆娘	婆乸
婆婆	奶奶	安人	家婆
婆婆媽媽	婆媽
婚紗店	婚紗舖
婢女	妹	妹仔
婦人	師奶
媒人	大葵扇
媒妁	大葵扇
媒婆	大葵扇	媒人婆
媒婆子	大葵扇
媳婦	家嫂	心抱	新婦
媽	老母
媽媽	亞媽	媽咪	老母	阿媽
媽媽-2	媽咪	老媽子	老母	阿媽
媽祖	天后
嫁不出去	中女	嫁唔出	攝灶罅
嫁到外國去的女子	過埠新娘
嫂嫂	亞嫂
嫂子	亞嫂
嫉妒心重的人	醋埕
嫌命長	壽星公吊頸
嫌麻煩	嫌費事
嫖妓	叫雞
嫖客	嫖友	雞蟲
嫣然一笑	蓮子蓉口面
嫩母雞	雞項
嫩菜心	菜薳
嫩菜薹	菜薳
嫩豆腐	水豆腐
嬌	嗲	嬌嗲
嬌小玲瓏	丁香
嬌慣	錫到燶
嬌柔	嬌嗲
嬌氣	嬌嗲
嬌滴滴	嬌嗲
嬌生慣養	身嬌肉貴
嬌生慣養的孩子	生骨大頭菜
嬌縱	縱	縱壞
嬌縱寵壞了的孩子	生骨大頭菜
嬌裡嬌氣	嗲聲嗲氣
嬌豔	鬼火咁靚
嬰兒	啤	啤啤	啤啤仔	牙丫	牙丫仔	牙呀仔	臊蝦	臊蝦仔	蘇蝦	蘇蝦仔	蘇蝦女
嬰兒背帶	孭帶
嬰兒車	啤啤車
嬰孩	啤	啤啤
嬸兒	亞嬸
嬸嬸	亞嬸
嬸子	亞嬸
嬸母	亞嬸
子	仔
子孫	孫孫塞塞
子孫眾多	開枝散葉
子彈	碼子
孑孓	沙蟲	蚊蟲
孔	咕窿	穿窿	窿
孔雀藍	姣婆藍
孕婦	大肚婆
字節	位元組
字號	大寶號	寶號	貴寶號
存	儲
存下来	儲埋
存儲	儲埋
存心	有心	立心
存款	入數
存錢	儲錢	入錢
孟加拉國	孟加拉
孤兒	孤兒仔
孤孤單單的一個人	一丁友	一支公
孤身一人	冇人冇物
孤陋寡聞	未見過大蛇屙屎	盟塞
孤零零一人	冇人冇物
孩子	細路仔
孫子	孫	孫仔
孱弱的孩子	孱仔
孵	哺
孵小雞	哺雞仔
學乖	學精
學位證書	紗紙
學別人	學人
學問	料
學徒	學師仔
學期末	學期尾
學校	學堂
學武術	食夜粥
學歷	quali
學習	學嘢
學舌	執人口水溦	學人口水溦	跟人口水溦
學著別人	學人
學識	料
學額	學位
孿生	孖生
孿生兄弟	孖仔
孿生兒子	孖仔
孿生姐妹	孖女
孿生子	孖仔
它	佢
守口如瓶	口密	密實
守夜	看更	睇夜	睇更
守時	依時依候
守舊	古縮
安全	穩陣
安全帽	頭盔
安可	安哥
安安穩穩	穩穩陣陣
安寧	安樂
安心	安樂	心息
安靜一下	靜吓
安靜下來	靜落嚟
完了	弊喇	煞尾科	玩完
完事兒了	攪掂
完全合口味	合晒心水
完全忘了	值情唔記得咗
完全沒有	冇晒
完全沒有精力了	殘晒
完全沒有辦法	冇晒符
完全沒有關係	三唔識七
完全相同	一個餅印
完婚	拉埋天窗
完成	埋尾	攪掂	跟手尾
完蛋	死梗	玩完	瓜	瓜得
完蛋了	凍過水	瓜柴	瓜直
宗族繁衍	開枝散葉
官位高	大粒
官兒大	大粒
官司	官非
定單	柯打
定弦兒	校線
定量供水	制水
定金	定	定銀
定錢	定銀
客人	人客	客	客仔
客戶	客仔
客梯	客猎
客氣	拘執
客源	客路
客滿	爆晒棚	爆棚
客貨車	van仔
客運升降機	客猎
客運電梯	客猎
宰	劏
宰人一筆	一頸血
宰殺	劏
宰豬	劏豬
害	跣	陰
害人精	佗衰家
害喜	漚仔
害怕	慌	手揗腳震	發驚青	窒	驚	驚青	驚青青	驚驚青青
害死	累死
害羞	怕醜
害臊	怕醜
害苦	玩死
宵夜	消夜
家	屋企
家人	屋企人
家傭	亞四
家具店	傢俬舖
家務	家頭細務
家務事	家頭細務
家喻戶曉	街知巷聞
家庭	一頭家
家庭主婦	師奶
家庭傭人	亞四
家庭婦女	師奶
家庭瑣事	家頭細務
家產	身家
家蠶	蠶
家裡的開支	家用
家財	身家
家鄉	鄉下
容易上火	熱氣
容易上火的	躁
容易上當的人	魚腩
容易做的工作	懶佬工夫
容易幹的活兒	懶佬工夫
容易戰勝的人	魚腩
容易打交道	搓圓撳扁
容易掉淚	眼淺
容易賺錢	好賺
容易辦	閒閒哋
容易通過	順攤
容易醒	醒瞓
容貌好	好樣
寄生小蟲	螆
密切配合	拍硬檔
密密麻麻	密質質
密封住	盟籠
密談	傾密偈	密斟
富有	有米
寒冷	冷
寒心	透心涼
寒磣	耷濕
寒酸	兜踎	豆泥
寡婦	寡婆	寡母婆
實價	一口價
實力雄厚	手瓜硬
實在	正一	正式
實實在在	實牙實齒
實實在在的	硬打硬
實際上	查實
寧可	情願
寧枉勿縱	有殺錯冇放過
寫下	寫低
寫下來	寫低	寫落嚟
寫得很清楚	標到明
寫意	盞
寫文章	揸筆
寫毛筆字	寫大字
寫清楚	寫到明
寫稿	爬格仔
寫記號	打交叉
寬	闊
寬敞	闊落
寬暢	闊落
寬窄	闊窄
寬米粉條	沙河粉	河	河粉
寬粉條	沙河粉	河	河粉
寬鬆	鬆身
寵	縱
寵壞	縱	縱壞	錫到燶
寵愛	錫到燶
寶獅	標緻
寶蓋兒	冧篷頭
寶蓋頭	冧宮頭	冧寶頭	冧弓頭	冧篷頭
寶貝兒子	寶貝仔
射	標
射出	標出
將來	第日
將心比心	以心為心
將會	嚟緊
將要	就
專家	老行專	行家
專心	好心機
專心致志	疊埋心水	的起心肝
專把聰明用在做壞事或為自己打算上	精埋一便
專用勒脖子方式打劫的匪徒	箍頸黨
專線	熱線
專輯	唱碟	大碟	片
專門跟…抬杠	專同…拗頸
尋找機會	吼機會
尋釁	踢館
對	啤	啱	摳	著
對…有利	益
對…有好處	益
對…有益處	益
對…說	講畀…知
對不對	啱唔啱
對不起	sorry	對唔住
對不起啊	sorry囉
對乙醯氨基酚	對乙酰氨基酚
對了	話時話
對了親家	做埋老襯
對他說	講畀佢知
對付	治
對兒	啤
對勁	妥
對勁兒	係路
對得起	對得住
對我來說	對我嚟講
對我說	講畀我知
對時間	對鐘
對準	踏正
對聯	對
對著	照
對襟衫	對胸衫
對話機	對講機
對象	拖友
對過	對開
對錶	較鐘
對面	對開
對頭	係路
導致	令到
小	細	細個
小不點兒	豆丁	豆丁仔
小丫頭	傻妹	僆妹	啤啤女	妹釘
小乖乖	乖乖仔
小九九	九因歌
小事	碎料
小事一樁	小事嚟啫
小人兒	公仔
小人書	公仔書
小休	小息
小伙子	僆仔	哥仔	後生仔	青年仔
小便	屙尿	屙殊殊
小便斗	尿兜
小便池	尿兜
小便處	尿兜
小個子	細個	豆丁仔
小偷	文雀	白撞	賊	賊仔	賊佬	鼠摸
小傢伙	僆琼	塞豆窿	死仔	百厭星
小傻瓜	壽仔
小兄弟	哥哥仔	細佬
小兒子	細仔
小兒科	碎料
小公雞	生雞仔
小凳	凳仔
小刀	刀仔
小叔子	叔仔
小吃	小食	點心
小吃店	小食店
小吃攤兒	食檔
小同學們	同學仔
小命不保	條命凍過水
小哥	哥仔
小商店	士多
小型公共汽車	van	小巴
小型公共汽車司機	小巴司機
小塊	忽
小壞蛋	衰仔
小女孩	僆妹	僆妹仔	啤啤女	妹釘	細路女	蘇蝦女
小女孩兒	女仔
小妞兒	僆妹
小妹妹	細妹
小姐	姐姐仔	密絲
小姑娘	僆妹	僆妹仔	大姐仔	女仔	姐姐仔	姑娘仔	細路女
小姑子	姑仔
小姨子	姨仔
小娃娃	牙丫	牙丫仔	臊蝦
小媳婦	心抱仔
小嬰兒	啤啤仔
小子	僆仔	僆琼	友仔	死仔
小孩	人仔	啤	啤啤	滲蚊仔	牙丫	牙丫仔	細佬哥	細蚊仔	細路	細路仔	細路哥	臊蝦	臊蝦仔	蘇蝦女
小孩兒	啤	啤啤	塞豆窿	細路	細路仔
小孩子	塞豆窿	細個仔	細蚊仔	細路	細路仔	細路哥
小學生	小學雞
小家子氣	小家	小家器	小家種
小小子	啤啤仔
小小年紀	細細個
小屋	屋仔
小山	山仔
小工人	打工仔
小巧玲瓏	的式
小巫見大巫	蚊髀共牛髀	蚊髀同牛髀
小巷	冷巷
小店	舖仔
小徒弟	學師仔
小心	因住	好聲	醒神
小心一點	醒少少
小心交友	帶眼識人
小心愛惜	儆錫
小心愛護	儆錫
小心眼兒	小器
小心著涼	因住凍親
小意思	小事嚟啫	濕濕碎	碎料
小憩	小息
小手提籃子	籮
小抄兒	貓紙
小拇指	手指屘
小指	尾指	手指尾	手指屘
小指頭	手指屘
小掃帚	掃
小掃把	掃
小排骨	牛仔骨
小數加起來就成大數目	小數怕長計
小數點	定點
小新聞	碎料
小昆蟲	蟲仔
小時候	細個仔嗰陣	細個嗰陣	細個嗰陣時	細時
小時工	鐘點	鐘點女傭	鐘點工
小朋友	同學仔
小本子	簿仔
小板凳	矮凳仔
小機靈	醒目仔
小母雞	雞項
小氣	低波	執式	孤寒	小器	小家	小家器	小家種	眼淺	荷包湆
小氣得要命	孤寒到死
小氣鬼	cheap精	孤寒佬	孤寒種	孤寒鐸	孤寒鬼	度叔
小汽車	房車
小河	河涌	涌
小洞	窿仔
小流氓	爛仔	蠱惑仔
小混混	蠱惑仔
小滑頭	蠱惑仔
小熊	熊仔
小熊玩具	啤啤熊
小爐子	風爐
小牛	牛仔
小牛犢	牛仔
小狗	狗仔
小猴子	馬騮仔
小瓦罐	罌
小甜餅	曲奇
小甜餅乾	曲奇
小男孩	哥仔	啤啤仔	細路仔
小白菜	白菜
小的時候	細個仔嗰陣	細個嗰陣	細個嗰陣時	細時
小看	看低	睇低	睇小	睇衰
小睡	瞌
小碗	兜
小碟酒菜	炒賣
小禮物	手信
小竹子	竹枝
小竹棍	竹枝
小笤帚	掃
小簍子	籮
小籃子	囖
小紅莓	金啤梨
小紅蘿蔔	甘筍仔
小老婆	二奶	亞細	妾侍
小老百姓	蟻民
小老虎	老虎仔
小聲	細細聲	細聲
小聲一點	細聲啲
小聲小氣	陰聲細氣
小聲點	細聲啲
小胖子	肥仔	肥仔嘜
小胡蘿蔔	甘筍仔
小胡闹	星君仔
小腸	粉腸
小腿	細髀	腳瓜	腳骨
小腿骨	腳骨
小舅子	舅仔
小舌	吊鐘	喉嚨椗
小舌兒	吊鐘	喉嚨椗
小船	艇仔
小艇	艇仔
小色鬼	麻甩仔
小菜	餸菜
小菜一碟	碎料
小蘇打	梳打粉
小螃蟹	蝦瘌	蟛蜞
小蟲	蟲仔
小街	橫街
小街小巷	橫街冷巷	橫街窄巷
小衚衕	冷巷
小豆甜粥	紅豆沙
小豬	乳豬	豬仔
小貓	貓仔
小費	貼士
小賣店	士多	小食店
小賣部	士多
小道消息	貼士
小雜貨店	舖仔
小雞	雞仔	雞僆
小雨	細雨
小雨淅瀝	雨溦溦
小青年	哥仔	後生細仔
小飛機	飛機仔
小馬	馬仔
小馬駒	馬仔
小騷貨	姣婆
小鬼	嘩鬼	小豆丁
小鳥	雀仔
少不了	唔少得
少不得	唔少得
少不更事	未生埋腦筍	腦筍未生埋
少女	僆女	僆妹	後生女
少女模特兒	僆模
少年	後生仔
少得可憐	奀過鬼
少東家	太子爺	少東
少爺	官	少
少男	僆仔
少管	懶理
少許	些少
少說	大大話話
少說兩句	講少句
少量	些少
尖兒	煙士
尖叫	大嗌
尖嘴薄舌	牙尖嘴利
尖尖的	尖筆甩
尖端	箭嘴
尚未竣工的樓房	爛尾樓
尤其是	尤其係
就	即
就…也不要緊	又點話
就一個人	一支公
就一次	一次過
就位	埋位	埋席
就差那麼一些	差少少
就席	埋位	埋席
就座	埋位	埋席
就快	就嚟
就按這樣辦	一於係噉話
就是	即係	實行	就係	直情	硬係
就是會	一味
就是說	即係話	就係講
就是這樣	係噉㗎啦
就會耍嘴皮子	得把口
就此打住	係噉先
就此罷休	就噉算	就噉算數
就著吃	食…送…
就這樣	係噉
就這樣吧	一於係噉	一於係噉啦	一於噉話	係噉先	係噉先喇	係噉話	就噉啦
就這樣算了	就噉算	就噉算數
就這樣行動	一於噉話
就這樣說定了	係噉話
就這樣辦吧	一於噉話	一於噉話啦
就這麼定	一於係噉
就這麼定了	一於係噉話
就這麼決定	一於噉話
就這麼著	一於係噉
就飯	撈飯
尷尬	冇表情	瘀	騎呢
尺子	間尺
尺寸	晒士
尺碼	晒士
尼姑	師姑
尼龍絲	膠絲
尾巴	尾
尾端	篤
尾聲	煞尾科
尾隨	跟	跟尾
尾骨	尾龍骨
尿尿	屙殊殊
尿布	尿片	屎片
尿床	賴尿
尿斗	尿兜
尿管	尿喉
尿臊味	餲
尿臊臭	餲
局促	屈質
屁滾尿流	標尿
屁股	pat	八月十五	噼噼	囉噼	囉柚	墩	屎窟	躉
屁股墩兒	躉
屁股大	躉大
屁股眼	屎眼	屎窟窿
居心	立心
居然可以這樣	噉又得	噉都得
屈從於現實環境	馬死落地行
屈服於壓力之下	大石責死蟹
屋子	房
屋簷	瓦簷口
屋頂	瓦坑	瓦背	瓦背頂	瓦面
屏住	掬
屢問屢不答	十問九唔應
山丘	山仔
山口	山卡罅
山崩	冧山泥	山泥傾瀉
山泥崩塌	冧山泥
山洞	山窿
山珍	野味
山谷	山卡罅
山體滑坡	冧山泥	山泥傾瀉
岌岌可危	岌岌貢
岳母	外母
岳父	外父
島	山	洲
島嶼	山	洲
崇拜者	擁躉
崩塌	冧
崴	戾
崴了	扭親
崴了一下	扭親
崴了腳	扭親隻腳
嶄新	新淨
巡邏	行beat	行咇
巢	竇
巢穴	竇	竇口
工人	打工仔
工休	唞工
工作	做嘢	工	打工	開工
工作緊張得手忙腳亂	做到七個一皮
工作褲	蛤乸衣
工作面試	見工
工作面談	見工
工具	家生	架罉
工地	地盤
工廠女工	工廠妹
工資	人工	糧	薪酬
工資少得可憐	人工奀過鬼
工資很低	人工好奀
工資很少	人工奀過鬼
工錢	人工
工頭	科文
左右	咁上下
左思右想	左諗右諗
左撇子	左吆	左撓	左撓仔
左看右看	左睇右睇
左轉	轉左
左邊	左便	左手便
巧	蹺
巧克力	之古律	朱古力	朱古律
巧克力冰淇淋	朱古力雪糕
巧克力渣兒	朱古力碎
巧克力片	朱古力碎
巧克力片餅乾	朱古力碎曲奇
巧克力聖代	朱古力新地
巧克力豆	朱古力碎
巧合	蹺
巧妙	蹺妙
巨石斑魚	龍躉
巫師	南無佬	神棍	茅山師傅
差	兒嬉	曳	水	流	爭	輸蝕
差一大截	爭好遠
差一點	差啲	差少少
差一點上當了	差啲領當喇
差一點點	差少少
差不多	七七八八	不過不失	咁上下	咁滯	咁高咁大	差唔多	麻麻	麻麻哋
差勁	屎	差皮	水皮	輸蝕	鮓	鮓斗
差得很遠	爭好遠
差得遠	未有耐
差池	差遲
差錯	差遲	漏罅	烏龍事
差點	爭啲
差點忘了	爭啲唔記得咗
已出嫁的女兒	外嫁女
已婚	結咗婚
已成定局	冇得玩
已經	經已
已經下了水	洗濕個頭
已經下水	洗濕咗個頭
已經來不及了	蚊瞓	蚊都瞓
已經做好準備	預咗
已經好了	好翻	好翻晒
已經沒問題了	好翻晒
已經治好了	好翻晒
已經這麼久了	隔咗咁耐
已經陷進去了	洗濕個頭
巴不得	宜得
巴掌	手板
市井之徒	街市仔
市場不景氣	市道低迷
市民	普羅大眾
市面上	坊間
布丁	布甸
布娃娃	毛公仔
布料	料
布松布拉	布瓊布拉
帆	𢃇
帆板	滑浪風帆
希望	聲氣
希特勒	希特拉
帥	cool	型	型仔	有型
帥呆了	型爆
帥哥	型男
帥男	型男
師娘	師太
師母	師太
席草	鹹水草	鹹草
帳單	單
帳篷	帳幕	營幕
帶上	帶埋
帶來	帶嚟
帶個話兒	搭句說話
帶傘	帶遮
帶勁	勁	夠勁
帶勁的歌	勁歌
帶在一起	帶埋
帶大	湊大
帶孩子	湊啤啤	湊細蚊仔
帶小孩	湊仔
帶條紋的	間條
帶眼鏡的男人	四眼佬
帶禮物	帶手信
帶著	佗住	監
帶走	外賣	搦走
帶頭人	頭
常	周時
常來往	行得埋
常例	例牌
常客	熟客	熟客仔
常常	周不時	周時	成日	時時	經常
帽子	帽	笠
幫不上忙	幫唔到手
幫不了	幫唔到
幫不了忙	混吉
幫人還債	幫人孭數
幫倒忙	倒竈	越幫越忙
幫倒忙者	倒米壽星	倒米壽星公
幫傭	鐘點	鐘點女傭	鐘點工
幫助	幫拖
幫助補貼	幫補
幫忙	幫手	幫拖
幫忙說話	幫口
幫我看著點兒	幫吓我眼
幫腔	加把口	幫口
幫著照看	幫眼
幫著看	幫眼
幫著看一看	幫吓眼
幫著看管	幫眼
幫說句話	加把口
幫說話	加把口
平均	通拉
平常事	閒閒哋
平平安安地過日子	安樂茶飯
平底鍋	平底鑊	煎pan	罉
平手	打和
平民百姓	普羅大眾
平衡	戥頭
年初	年頭
年夜飯	團年飯
年宵市場	花墟	花市
年少	僆
年幼	細個	細細個
年底	年尾
年根兒底下	挨年近晚
年紀大	大個
年紀小	年紀細	細個	細細個
年紀小小	細細個
年紀很小	細細個
年終獎金	年尾花紅
年貨市集	花墟	花市
年輕	僆	嫩	後生
年輕人	世姪	僆仔	後生仔	後生仔女	後生細仔
年輕女子	後生女
年輕姑娘	後生女
年輕學生	學生哥
年輕小伙子	花僆	花僆仔
年輕小姑娘	花僆女
年關將近	挨年近晚
年關時	挨年近晚
幸亏	好在
幸好	好在	好彩
幸災樂禍	心涼
幸虧	好彩
幹不了	做唔嚟	做唔掂
幹不完	做唔完
幹了它	飲勝佢
幹什麼	做乜	做咩
幹出來	做出嚟
幹嘛	做乜	做咩
幹掉	做低	𢷮冧
幹活	做嘢
幹活不夠利落	湆手湆腳
幹活沒有多少錢收入	冇厘油水
幹活累得頭暈眼花	做到七彩
幹粗活的	打仔
幹著幹著	做做吓
幹雜務的	打仔
幹雜工	打雜
幼兒園	幼稚園
幼稚	未生埋腦筍	腦筍未生埋
幼鴿子	乳鴿
幾乎	爭啲
幾乎沒	乜滯	冇乜滯
幾乎沒有	乜滯	冇乜滯
幾十年	幾廿年
幾塊錢	幾蚊雞
床墊	床薦	床褥
床底	床下底
床底下	床下底
床底下的空間	床下底
床鋪	床
底	篤
底下	下低	下便	下底
底下的	篤底
底兒朝上	打倒掟
底子不好	二仔底
底層的	篤底
底座	躉
底片	相底
底細	波路
底部	篤
店員	伙記
店舖	商舖	舖
店舖關門	埋閘
府上諸人均在邀請之列	闔府統請
府綢	竹紗
府綢衣服	竹紗衫褲
座	堂
座位	卡位
座無虛席	爆棚
庵寺	齋堂
康復	好翻
庸庸碌碌	胡胡混混
庸醫	黃綠醫生
廁所	屎坑
廉價	平價	爛平爛賤
廉價售賣	平沽
廉價市場	平價市場
廉價賣人情	賣大包
廉價送人情	賣大包
廉政公署	廉記
廚藝	手勢
廝殺	劈友	開片
廟祝	廟祝公
廢氣管	死氣喉
廢物	廢柴
廢話	齋噏
廢話少說	廢話少講
廢話！	你講嘢呀？
廣告	告白
廣州	省城
廣州別稱	花城
廣州話	白話	省城話
廣府話	白話
廣東話	白話
延伸檔名	副檔名
延後	褪後
延期	押後
延遲	褪後
延長線	拖板	拖蘇
建築事務所	則師樓	則樓
建築工人	地盤工人
建築工地	地盤
建築師	則師	畫則師
建築設計圖	圖則
建築設計師	則師	畫則師
弄	整
弄一些噱頭	攪攪新意思
弄不了	攪唔掂
弄不回去	整唔翻
弄不好	慢下手	整唔掂
弄亂	整亂
弄亂了	撈亂咗
弄傷	整傷	整損	整親
弄出來	整出嚟
弄哭	整喊
弄回來	撻翻嚟
弄壞	扠堝	攪堝	攪衰	整爛
弄壞了	整爛咗
弄好	攪妥	攪掂
弄妥	攪掂
弄幾個菜	整翻幾味
弄幾道菜	整翻幾味
弄彎	屈
弄得	攪到
弄得一塌糊塗	攪到烏喱單刀
弄得很混亂	攪到七個一皮
弄得手忙腳亂	攪到七個一皮
弄得這麼嚴重	攪到咁大劑	攪到咁大鑊
弄得雞犬不寧	攪到雞毛鴨血
弄成這樣	攪成噉
弄濕了衣服	濕身
弄痛	整痛
弄破	整損	整爛
弄破了手	整損手
弄糕	攪堝
弄糟	扠堝
弄虛作假	出貓	出貓仔	出貓招	裝假狗	超技術
弄錯	擺烏龍	擺老烏	攪錯	表錯情
弄髒	整污糟
式樣	花款	花臣
式樣好	好樣
引渡集團頭目	蛇頭
引火	透火
引火燒身	周身蟻
引诱	勾
引起	惹
引起公憤	犯眾憎
弟妹	弟婦
弟婦	阿妗
弟弟	細佬
弱	孱
弱小	奀
弱點	痛腳
張	堂	擘
張三李四	亞保亞勝	亞狗亞貓	亞甲亞乙	亞豬亞狗
張口呼氣	㗾
張口結舌	O咀	O晒咀	擘大個口得個窿	擘大口得個窿
張大	擘大	睩
張大嘴巴	擘大個口
張大眼睛	睩眼
張大雙眼	睩大眼	睩大雙眼
張著嘴巴	擘大個口
張貼	標貼
張開	掗開	擘	擘開
張開兩個手指	擘開兩隻手指
張開兩條腿	掗開對腳
張開嘴	擘開個口
張開嘴巴	擘大口
張開雙腿	擘髀
強人所難	監人賴厚
強令	扤
強使	扤
強加	安
強勁	勁
強勁有力	手瓜起腱
強盜	賊佬	賊公
強辯	死雞撐硬腳	死雞撐飯蓋
強迫	屈	監
強酸	鏹	鏹水
彆扭	冇表情	騎呢
彈吉他	彈結他
彈球	波子	波珠
彈簧	彈弓
彈簧夾	魚尾夾
彈簧床	彈床
彈腿	䟴䟴腳	䟴腳
彈響手指	打個響指
彈響指頭	打個響指
彌猴桃	奇異果
彌補	補數
彌補缺陷	執生
彎	攣
彎下	彎低
彎下來	彎低
彎下腰	彎低	烏低	烏低腰	烏低身	踎低身
彎下腰來	彎低	烏低腰
彎彎曲曲	九曲十三彎	攣捐
彎折	拗
彎曲	屈	攣	攣曲	曲
彎腰	彎低	烏低	烏低腰	烏低身
彎身	烏低	烏低腰	烏低身
彎鐵絲	屈鐵線
彗星	掃把星
形容某些人阻礙人家發展	阻住地球轉
形影不離	糖黐豆
形影不離的人	孖公仔
形狀不規則	三尖八角
影迷	擁躉
影響大	猛料
彼此彼此	大家噉話	大家都噉話
往上爬	上位
往下垂	惰
往前走	向前行
往回	翻轉頭
往回走	行翻轉頭
往後退	褪後
待一會兒	一陣間
待以後再處理	押後處理
待會兒	聽暇
待遇	薪酬
很	不知幾	十分之	好	死咁
很不專心	好冇心機
很不錯	好勁
很久	好耐	浸死鴨乸	浸死鴨乸咁耐
很久以前	一早
很久很久以前	好耐好耐之前
很乾淨	乾乾淨淨
很了不起	好勁	好醒
很亮堂	光巉巉	光棖棖
很便宜	好抵	抵到爛	爛平爛賤
很值	抵到飛起
很傷心	好灰
很像	似層層	似足
很像樣	好好睇睇
很像真的	似層層
很兇	兇神惡	兇神惡殺
很光亮	光巉巉	光棖棖	光猛
很入時	好型
很划算	好抵	抵到飛起
很厲害	好交關	好勁
很可憐	好陰功
很可能	慢下手	都似
很可靠	穩穩陣陣
很吃力	好嗍氣
很合算	好抵	抵到飛起
很囉嗦的人	長氣袋
很圓	圓碌碌
很多	多多	多多聲	多羅羅	大把	好多
很多回	好多勻
很多時候	好多時
很多次	好多勻
很多麻煩	一身蟻
很好	好嘢	好好	好盞
很好吃	好好味
很好的人	好人好姐
很好看	好型
很妙	好盞
很嬌氣	嗲聲嗲氣
很安全	穩穩陣陣
很容易	容乜易
很容易辦	好閒
很容易辦的事	好易話為
很小的嫌隙	隔夜仇
很少	奀過鬼
很少的東西	少少嘢
很巧	好蹺
很差	屎
很帥	好型
很平常的	好閒
很快	快過打針
很悶	好焗
很惱火	真火滾
很愛賭博的人	爛賭二
很感謝	多謝晒
很慘	好灰
很憤怒	好嬲
很懶惰	死蛇爛鱔噉
很投機	好啱key
很擁擠	好逼人
很斯文	斯斯文文
很明亮	光巉巉	光棖棖
很時尚	好潮
很時髦	好型
很晚	好夜
很晚了	夜麻麻
很暖和	暖粒粒
很曝曬	好曬
很有把握	定過抬油
很有膽量	膽生毛
很棒	勁抽	好到冇朋友	好勁	好嘢	好盞	正晒
很機靈	好醒
很滋補的	好補
很滋補的湯	靚湯
很漂亮	好靚
很灰心	好灰
很無聊	勁悶
很熱	熱熱哋	熱辣辣
很燙	熱辣辣
很牢靠	穩穩陣陣
很甜	甜甜哋
很生氣	好嬲	把幾火	真火滾	食咗火藥
很疼你	錫晒你
很瘦	瘦到成條柴噉
很相象	似模似樣
很神氣	好醒
很穩固	穩穩陣陣
很穩當	穩穩陣陣
很笨	蠢過隻豬
很簡單	簡簡單單
很精彩	好睇過睇戲
很糟糕	好弊
很累	好癐
很美味	好好味
很聰明	好叻	好醒
很聽話	聽晒笛
很能幹	好做得
很興奮	好high
很舒服	舒舒服服
很色	鹹濕
很要好	好friend
很要好的朋友	friend過打band
很談得來	好傾
很負責任	有腰骨
很費力	好嗍氣
很費勁	好嗍氣
很軟	軟腍腍
很辛苦	好嗍氣
很辣	辣辣哋
很近	好近
很過份	咁盡	幾盡
很遙遠的地方	冇雷公咁遠
很適合你	幾襯你喎
很邪門	好邪
很酷	好型
很酸	酸微微
很長	水蛇春咁長	長流流
很陡	好斜
很隨便的	求求其其
很難找的人	冇尾飛陀
很難看	生得醜
很難說	好惡講	話唔埋
很難走	好惡行
很餓	好肚餓	餓鬼投胎
很香	香噴噴
很髒的人	污糟貓
很高大	高高大大
很鬆弛	削笪笪
很鹹	鹹鹹哋
很麻煩	麻鬼煩
律師	狀師
律師事務所	律師樓
律師副手	師爺
律師證明	律師紙
後	孻	孻屘	屘
後來	冧屘	後嚟	後尾	收屘	褸尾
後備箱	車尾
後備車輪	士啤肽
後備輪胎	士啤肽
後台	手骨
後娘。	後底乸
後媽	後底乸
後悔莫及	知死
後母	後底乸
後腦勺	後尾枕	後枕
後車廂	車尾
後退	打倒褪	褪
後邊	後便
後面	後便
徑直	掂筆甩
徒勞	賺	賺攪
徒勞地	枉
徒勞無功	混吉
徒然	賺	賺得
得	攪掂
得不償失	執條襪帶累身家
得不到利益	冇嘢到	冇料到
得了感冒	作感冒
得到利益	飲頭啖湯
得到好東西	執到寶	執到著數
得到好處	執到著數	飲頭啖湯
得寸進尺	得一想二
得意	得戚
得意忘形	得戚	得敕	老竇姓乜都唔知	頭揈揈
得意洋洋	得戚	得敕	心涼
得手	得米
得獎	攞獎
得理不饒人	有風駛盡𢃇
得罪不起	唔得罪得
得罪了	得罪晒
得計	得米
從	由
從…說起	由…講起
從…開始	起首
從不	冇話
從來	從嚟
從來不會	冇話
從來沒有	冇話
從內地來香港的新移民	亞燦
從前	舊底	舊時
從外地來做工的姑娘	外來妹
從容	他條	定當
從小	自細
從小到大	由細到大
從早到晚	一日到黑
從現在開始	由而家開始
從零開始	拆棚做過
從頭做起	拆棚做過
從頭到尾看一遍	由頭睇到落尾
復活	翻生
循規蹈矩	有規有矩
微笑	笑笑口
微笑的樣子	笑笑口
微笑著說	笑笑口噉講
徹夜不眠	捱更抵夜
徹底治好	斷尾
徹底玩完了	蛇都死喇
徽章	襟章
心上人	打令
心中堵得慌	哽心
心中憋氣	條氣唔順
心中憋氣發悶	屈悶
心中掛念	心掛掛
心中明白	心知肚明
心中有底	有分數
心中有數	心知肚明	有分數
心中氣悶	翳氣
心中牽掛	心掛掛
心中痛快	心涼	心甜
心亂如麻	啦啦亂	立立亂
心兒	肉
心口不一	口唔對心
心安理得	過意得去
心平氣和	好聲好氣
心思細密	心水清
心急	喉急
心情	心機
心情不佳	心情唔靚
心情不好	心情唔靚
心情好	合皮	好唱口
心情很舒暢	條氣順晒
心情抑郁	閉翳
心情暢快	疏肝
心情極佳	心情極靚
心情極好	心情極靚
心情特好	心情極靚
心情舒暢	精神爽利
心想	心諗
心意	心水
心愛	心水
心慌意亂	慌晒
心散	喪
心氣高	心頭高
心灰意冷	心淡
心焦	心悒
心照不宣	心照	心知肚明
心煩	心悒
心甘情願	心甘命抵
心疼	肉痛	肉赤
心直口快	直腸直肚
心神不安	啦啦亂	立立亂
心窩	心口
心緒不寧	心情唔靚
心肝寶貝	心肝椗
心腸好	好人事
心血	心機
心裡七上八下	個心十五十六
心裡不安	唔安樂
心裡不舒暢	唔安樂
心裡亂糟糟的	個心十五十六
心裡很煩悶	個心好翳	心好翳
心裡想	心諗
心裡揪著	哽心
心裡明白	心水清	心照	心知肚明
心裡有底	有分數
心裡有數	定當	定過抬油
心裡留不住話	口疏
心裡癢癢的	心喐喐
心裡納悶	心噏
心裡老惦著	心掛掛
心裡老想著	心思思
心裡舒暢	心甜
心野	喪
心靜平靜下來	條氣順晒
心願	心水
必死無疑	死梗
必須…嗎？	使唔使…呀？
忌	棹忌
忌口	戒口
忌諱	棹忌	避忌
忍不下氣	唔忿	唔忿氣
忍不住	唔抵得	忍唔住	忍唔到	抵頸唔住
忍不住想說	口痕
忍不住氣	抵頸唔住
忍受	抵
忍受不了	頂唔順
忍受不住	頂唔順
忍受著	頂硬上
忍得住氣	抵得頸
忍氣吞聲	揸頸	揸頸就命
忍氣認命	揸頸就命
忍耐著	頂硬上
忍著寒冷	抵冷
忍飢捱餓	捱飢抵餓
忐忑不安	個心十五十六	十五十六	發驚青	驚青青	驚驚青青
志向高	心頭高
志工	義工
志願工作者	義工
忘乎所以	老竇姓乜都唔知
忘了	冇醒起	唔記得咗	漏咗
忘了帶	漏低	漏咗
忘恩負義	反骨無情
忘恩負義的人	反骨仔
忘記	唔記得	漏
忘記拿	漏低	漏咗
忙	唔得閒
忙不迭地答應	漯飯應
忙得不亦樂乎	做到金睛火眼
忙得不可開交	做到七彩	忙到七彩
忙得喘不過氣來	做到氣咳
忙得團團轉	忙到七個一皮
忙得昏頭轉向	忙到七彩	忙到踢晒腳
忙死了	忙到死
忙碌	頻撲
忠貞	純情
快	利	將近	就嚟	快脆	快馬	衡
快一點	啦啦林	啦啦聲	快啲
快一點去吧	啦啦聲去啦
快快	快快脆脆
快快長大成人	快高長大
快樂	安樂	歡喜
快活	安樂
快熟麵	公仔麵
快當	快脆
快要	咁滯	將近	就嚟
快過年了	挨年近晚
快遞	速遞
快遞員	速遞員
快遞車	速遞車
快門	失打
快點	快手快腳	快馬啲	速速
快點兒	快馬啲
快點吧！	快啲啦！
快點走吧	快啲行喇
念完經趕和尚	打完齋唔要和尚
念念不忘	心思思
念經	南無
念頭	諗頭
忽冷忽熱	暴冷暴熱
忽略	眼大睇過籠
怎樣	點	點樣
怎樣去做	點做
怎樣才好	點好呢
怎樣說都可以	點話點好
怎樣？	點鬼樣
怎麼	點	點樣
怎麼也	一於
怎麼也不相信	打死唔信
怎麼了	做咩	咩事	咩事啫
怎麼了？	做咩啫？
怎麼做也做不過來	做極都唔掂
怎麼可以	點可以
怎麼可以這樣	噉又得	噉都得
怎麼少得了	點少得
怎麼想也想不明白	諗極唔明
怎麼成	點得
怎麼搞的	點攪㗎
怎麼會	點會
怎麼會是你	乜係你
怎麼會這樣	乜噉	乜噉嘅	做乜噉嘅？
怎麼會這麼巧	咁啱嘅
怎麼樣	咩事	點	點樣	點睇
怎麼樣就怎麼樣	幾大就幾大	幾大就幾大，燒賣就燒賣
怎麼樣？	乜嘢環境？	咩嘢環境呀？	咩環境呀？	咩環境？
怎麼看	點睇
怎麼知道	點知
怎麼能…	…都有嘅
怎麼行	點得
怎麼說	點講
怎麼說也不行	乜都假
怎麼說就怎麼辦	點話點好
怎麼辦	點好	點好呢	點算
怎麼辦呢	點呢
怎麼辦才好	點算好
怎麼這麼…	乜咁…
怎麼這麼湊巧	咁啱嘅
怎麼那麼…	乜咁…
怎麼都可以	點話點好
怎麼都要	點都要
怎麼？	乜嘢話？
怒不可遏	火遮眼
怒從心上起	心頭火起
怒氣沖沖	食咗火藥	黑面
怒火中燒	火遮眼
怒目圓睜	眼超超
怒視	眼超超
怕	慌	慌怕	驚
怕人看見	閃閃縮縮
怕冷	怕凍	驚凍
怕死	錫身	驚死
怕癢	怕擳
思前想後	諗諗吓
思念	掛住	掛望
思想閉塞	盟塞
思索妙計	度橋	諗橋
思考	諗嘢
思覺失調症	精神分裂症
思路清晰	心水清
急	喉急	心急
急不可待	發驚青	驚青青	驚驚青青
急切	喉急
急匆匆	擒擒青
急得團團轉	急到氹氹轉
急忙	擒青	狼忙
急急忙忙地	急急腳
急性子	炮仗頸
急於大便	屎急	急屎
急於小便	尿急	尿急急	急尿
急著用錢	等錢使
急診室	急症室
急躁	躁
急速下滑	暴瀉
性交	撲嘢	造愛	開鑊
性子急	喉擒
性子慢	[湆]	湆懦	漏氣
性子慢而軟弱	湆懦懦
性急	喉急	躁暴	躁火
性情爽直	直腸直肚
性感	激凸	錫士
性格不爽快	[湆]
性格黏糊	湆懦懦
性涼	涼氣
怪…的	鬼咁…	鬼死咁…
怪不得	唔怪之得	唔怪乎	唔怪得	怪之得	怪唔之得	怪唔得
怪人	騎呢𧊅
怪怪的	神神化化
怪手	剷泥車	雞頭
怪異	邪
恐嚇	淋紅油
恐慌	發驚青	窒	驚青	驚青青	驚驚青青
恐懼	慌晒
恐高	畏高
恐高症	畏高症
恨	憎
恨透	憎死
恩將仇報	食碗面反碗底
恭喜發財	恭喜發財，利是豆來
恭維	笠高帽
恰巧	湊啱	蹺
恰恰	查查
恰恰舞	查查	查查舞
恰當	妥
悄悄地	靜雞雞
悄悄地做	揞密鑼鼓
悠然	他條
悠蕩	吊吊揈
悠閒	他他條條
患	惹咗
患夜盲症	發雞盲
患寄生蟲病	生蟲
患性病	乃嘢	生花柳
患感冒	作感冒
患梅毒	生花柳
患疳積病	生癪
患疳積病的小孩	生癪仔
患病	乃嘢	作病
患癌	生cancer
患癌症	生cancer
患皮膚病	生螆
患難與共	同撈同煲	同煲同撈
您早	早晨
您真的很關心我	真係有心
悶	焗	翳焗
悶住	盟籠
悶在家裡	屈喺屋企
悶熱	焗	焗悶	焗熱	翳焗	翳熱
情人	拖友
情人眼裡出西施	各花入各眼
情夫	契家佬
情婦	二奶	契家婆
情意纏綿	埕埕塔塔
情書	情信
情況	波路
情節	橋段
惠顧	幫襯
惡少	惡爺	惡爺頭
惡意攻擊	淋紅油
惡棍	爛佬
惡毒	陰毒
惡狠狠	惡死能登
惡霸	牛王頭	陀地
惦念	掛住	掛望	記掛
惦念著	心思思
惦著	心思思	記掛
惦著…	掛住…
惦記	掛住	掛望
惦記著…	掛住…
惱怒	食咗火藥
惱火	撞火	火滾	食咗火藥
想	估	宜得	指擬	諗	諗住
想…都不行	想…都唔得
想一下	諗吓	諗諗吓
想一想	諗吓	諗落	諗諗吓
想一想看看	諗過
想不到	估唔到
想不起來	醒唔起
想不透	諗唔明
想不通	諗唔掂	諗唔明	諗唔通
想不開	睇唔開	諗唔通
想主意	度橋	諗橋
想了太多	諗多咗
想事情	諗嘢
想來	諗起上嚟
想來想去	諗諗吓
想來想去就是想不通	諗極唔明
想別人同情	搏同情
想到	諗到	醒
想吐	想嘔
想哭的樣子	喊喊口	喊噉口
想多了	諗多咗
想太多了	諗多咗
想好	諗掂
想得起	記得起
想得開	睇得化	睇開
想念	掛住	掛望
想想	諗吓	諗諗吓
想想看	諗過
想打架	嫽交打
想歪	諗邪
想歪了	諗邪
想法	諗法	諗頭
想法子	度橋	諗橋
想清楚	攝高枕頭	薦高枕頭	諗清楚	諗清諗楚	諗真
想清楚一些	諗真啲
想清楚一點	諗真啲
想清楚點兒	諗真啲
想睡覺	眼瞓
想著少花錢	諗縮數
想要	吼斗
想計謀	度橋	諗橋
想起	記起	諗翻	諗起	醒	醒起
想起來	諗翻	諗起	諗起上嚟	醒起
想辦法	度橋	諗掂	諗橋	諗計	諗計仔
想通	諗掂	諗通
想通了	諗掂咗
想都不用想	諗都唔好諗
想都不要想	諗都唔好諗
想錢想瘋了	發錢寒
想開	睇開
惹一身臊	惹屎上身	揦屎上身
惹一身麻煩	周身蟻
惹上很多麻煩	周身蟻
惹了一身麻煩	攪到一身潺
惹了大禍	乃嘢	乃大鑊	乃鑊	大鑊	揩鑊
惹了很多麻煩	周身蟻	揩鑊
惹事生非	嫽是逗非
惹人愛	精乖	精乖乖
惹人憎惡	乞人憎	得人憎
惹得	嫽到
惹得許多麻煩	攪到一身潺
惹怒	激嬲
惹惱	激親
惹是生非	嫽是逗非
惹火燒身	周身蟻
惹生氣	激	激嬲	激親
惹禍	乃嘢	乃大鑊	乃鑊
惹禍上身	周身蟻
惹麻煩	乃嘢	乃大鑊	乃鑊	倒米
愁	憂
愁悶	閉翳
愁眉苦臉	揦口揦面	揦埋口面	苦口苦面	苦瓜乾噉口面	苦瓜噉口面	苦瓜噉嘅面	苦瓜噉面	苦瓜面
愁眉苦臉的人	苦瓜乾
愁雲滿臉	苦瓜乾噉口面	苦瓜噉口面	苦瓜噉嘅面	苦瓜噉面	苦瓜面
愉快	安樂	梳芙
意味著	意味住
意大利粉	意粉
意大利麵	意粉
意大利麵條	意粉
意見不合	唔啱牙	摳唔埋
愚弄	搵人笨	搵人老襯	搵笨
愚笨	死蠢	老襯	蠢頓
愚蠢	壽	豬嘜
愚蠢的人	豬頭柄
愚鈍	呆鈍	蠢頓
愛人	打令
愛出風頭	叻唔切
愛出風頭的人	風頭躉
愛司	煙	煙士
愛吃	爛食
愛吃醋的人	醋埕
愛吹噓自己的人	白霍友
愛吹毛求疵的	醃尖
愛哭	喊口	爛喊	眼淺
愛哭的孩子	爛喊貓
愛好	歡喜
愛好成癖	爛癮
愛好者	粉絲
愛怎樣就怎樣	幾大就幾大	幾大就幾大，燒賣就燒賣
愛情不專一	花心
愛惜	痛錫
愛打架	爛打
愛挑剔的	醃尖
愛撤嬌的孩子	扭計星
愛攀緣的	擒騎
愛欺負人的	蝦蝦霸霸
愛漂亮	貪靚
愛爬上爬下	擒騎
愛玩	爛玩
愛玩樂的女孩	𠿭妹
愛理不理	唔嗲唔吊
愛睡覺	爛瞓
愛笑鬧	大癲大廢
愛管閒事	八卦	巴揸
愛管閒事的	八
愛管閒事的女孩	八卦妹	八妹
愛罵街的人	嗌通街
愛美	貪靚
愛耍小聰明	精
愛花錢	大使
愛裝扮	姿整
愛說下流話	爛口
愛說俏皮話	口花花
愛說大話	下扒輕輕	口輕輕
愛說粗話	爛口	粗口爛舌
愛說話	好傾好講
愛說說道道	好傾好講
愛說髒話	爛口
愜意	盞
感冒	傷風	冷親
感到	覺
感到反感	眼冤
感到如何	覺點
感到討厭	眼冤
感激不盡	多得晒
感覺	feel	sense	覺
感覺怎樣	見點
愣	木獨	眼光光
愣了一下	打咗個突
愣住了	定晒形
態度消極	放䠋
慌張	失魂	揗晒雞	揗雞	發驚青	驚青	驚青青	驚驚青青
慌慌張張	慌失失
慌手慌腳	慌失失
慘了	死啦
慢三拍	漏氣
慢吞吞	[湆]	嚤佗	湆懦
慢慢…吧	慢慢
慢慢品嚐	嗒真吓	嗒真啲
慢慢地	慢慢	整整吓
慢慢聊	慢慢傾
慢慢說	慢慢講
慢手慢腳	湆手湆腳
慢條斯理	漏氣
慢火	老火
慢火熬湯	老火湯
慢著	咪住	慢住
慢走	好行	慢慢行
慣例	例牌
慣壞	縱	縱壞	錫壞
慣家	撈家
慣犯	積犯
慪氣	霎氣	鬥氣
慫慂	慫	𢷮鬼
慷慨捐獻	大破慳囊
慾望大	開胃
憂愁	閉翳
憂慮	憂
憂鬱	心悒
憋	掬
憋不住尿	尿急	尿急急	急尿
憋不住屎	屎急	急屎
憋尿	尿急	急尿
憋悶	屈質
憋氣	屈氣	掬氣	揸頸	翳	翳氣
憋著大便	屎急	急屎
憋著尿	尿急	急尿
憑什麼	憑咩
憑空編造	生安白造
憤怒	眼火標
憤憤不平	條氣唔順
懂	un	明	曉
懂不懂	明唔明
懂不懂？	你un唔un呀？
懂事	生埋腦筍	生性	精乖	精乖乖	識性
懂人情世故	識做
懂得	識得
懂得享受	識歎
懂得勤儉節約	知慳識儉
懂得吃喝	識飲識食
懂得怎麼辦	識do	識做
懂得節儉	知慳識儉
懂門路	熟行
懇求	噅	噅求
應付錢而不付錢	霸王
應召女郎	私鐘妹	鳳姐
應名兒	話名
應用程序	應用程式
應該	應份
應變	執生
懊悔	抌心口
懲罰	罰
懵懂	大懵	懵	懵閉閉
懵懵懂懂	懵盛盛	懵閉閉
懵然不知	懵盛盛
懶人	死蛇爛鱔
懶得	費事
懶得去管	費事理
懶得管	冇眼睇
懶得說	費事話
懶惰	懶	蛇
懶懶散散	死蛇爛鱔噉
懶散	放䠋	迆
懶洋洋	唔嗲唔吊
懶漢	懶佬
懶漢鞋	懶佬鞋
懶蛋	蛇王
懶蟲	死懶鬼	爛瞓豬	蛇王
懶骨頭	蛇王
懶鬼	死懶鬼
懷上孩子	佗仔	佗住啤啤	佗啤
懷孕	佗	佗人	佗仔	佗住啤啤	佗啤	大肚	有咗肚	有身紀	粗身大細
懷孕了	大咗肚	有咗
懷小孩	佗仔	佗住啤啤	佗啤
懷疑	思疑
懷著	佗住
懷著孩子	佗啤
懷錶	砣錶
懸雍垂	吊鐘	喉嚨椗
懼高	畏高
懼高症	畏高症
戀人	拖友
戀家	傍家	黐家
成了	得喇
成人	大人大姐
成人電影	鹹濕片	鹹片
成人電視台	四仔台
成功	掂	攪掂
成功少碰壁多	撞板多過食飯
成年人	大人大姐
成心	立心
成本高	重皮
成熟	生埋腦筍	黃
我不會騙你的	風水佬呃你十年八年
我們	我哋
我們的	我哋嘅
我們老倆口	我哋兩老
我們自己	我哋自己
我們自己的	我哋自己嘅
我告訴你	我話你知
我對你說	我話你知
我的	我嘅
我的為人	我個人
我自己的	我自己嘅
我請客！	我嘅！
我請！	我嘅！
戒不掉	戒唔甩
戒掉	戒甩
戒賭	斬手指
或多或少	唔多唔少
或者	一係	定	抑或
戥子	厘戥
截	碌
戲劇的關鍵部分	戲肉
戲劇的高潮	戲肉
戲弄	嫽
戳	拮	督
戳傷	拮親	督親
戳破	拮穿	拮親	督穿
戳穿	督爆
戳脊樑骨	督背脊
戴上面具	幪面
戴眼鏡的	四眼
戴眼鏡的人	四眼佬
戴眼鏡的女孩兒	四眼妹
戴眼鏡的姑娘	四眼妹
戴眼鏡的男孩	四眼仔
戴眼鏡的男青年	四眼仔
戴綠帽子	做龜公
戴綠帽子的人	龜公
戴面具	幪面
戴面具的人	幪面人
戴高帽	笠高帽
房地產	地產	物業
房地產證	屋契	樓契
房子	單位	屋	樓	樓盤
房子分期付款	供屋
房客	住客
房屋買賣易主	交吉
房東	屋主
房東太太	屋主婆
房產稅	物業稅
房產證	屋契	樓契
房租	屋租	租金
房簷	瓦簷口
房貸	按揭
房間	房
房頂	瓦坑	瓦面
所謂	之所謂
扁平足	鴨乸蹄
扁擔	擔挑	擔竿
扇	撥
扇扇子	撥扇
手上的繭子	手枕
手上的老繭	手枕
手中沒錢	冇銀喺手
手中無東西	空手掉空臂
手剎車	手掣
手印	手指模	指模
手在發抖	手震震
手太緊張	手緊	水緊
手套	手襪
手巧	抵手
手帕	手巾仔
手心	手板	手板堂	手板心
手心兒	手板堂	手板心
手心朝上	攤大手	攤大手板
手忙腳亂	倒瀉籮蟹	手揗腳震	揗晒雞	揗雞	踢晒腳	踢腳
手感好	爽手
手感潤滑	幼滑
手托下巴	托下扒
手拉著手	拖手仔
手指甲	手甲	指甲
手指節	手指纈
手掌	手板
手提包	手袋
手提小籮	囖
手提揚聲器	大聲公
手提箱	公事喼
手提籃	手抽
手提袋	手抽
手杖	士的
手榴彈	菠蘿彈
手槍	炮
手機	手提	手提電話
手段低下	低波
手淫	自慰
手牽手	手拖手
手癢	手痕
手癢癢	手痕
手紙	廁紙	草紙
手絹	手巾仔
手肘	手踭
手背朝下	攤大手	攤大手板
手腕	手骹
手腕子	手骹
手腳不靈	手揗腳震
手腳亂顫	手揗腳震
手腳損傷	損手爛腳
手腳發抖	手揗腳震
手腳破損	損手爛腳
手腳都摔破了	損手爛腳
手腳都有傷	損手爛腳
手腳麻利點兒	快馬啲
手臂	手瓜
手臂結實	手瓜起腱
手被扭傷了	屈親隻手
手裡拿著	揸手
手足無措	揗晒雞	揗雞
手銬	手鐐
手錶	腕錶	錶
手鐲	手鈪	鈪
手閘	手掣
手電筒	電筒
手頭拮據	手緊	水緊
手頭緊	手緊	水緊	等錢使
手頭缺錢	乾晒塘	五行欠水	五行缺水
才	先	先至	啱	至
才…啊	㗎咋
才不會	先至唔會
才只	得翻
才好	先得	至好
才學	料
才對	至啱
才幹	quali	料
才怪呢	就假嘅
才成	至得
才是	至係
才有	得翻
才能	料
才華	料
才行	先得	至得
扎	劖	拮	督	錐
扎人	拮肉
扎堆	埋堆
扎實	實淨
扎猛子	插水
扎破	拮穿	拮親
扎破了	劖親
扎破了手	拮親手
扎著雙辮	扎孖辮
扎馬步	扎馬
扒	摱
扒下所有的衣服	剝光衫褲	剝光豬
扒手	文雀	荷包仔	荷包友
打	[拂]	㨘	㩧	喐	抦	泵	砌	鬆骨	𢱕
打一個結	綁個纈
打一個耳光	摑一巴掌
打一拳	𢱕一拳
打上馬賽克	打格仔
打下來	㩧落嚟
打下去	㩧落去
打不了主意	咬唔入
打不通	打唔通
打不過他	唔夠佢打
打人	拍薑噉拍
打住	閘住
打倒	打低
打傘	擔遮
打傷	㩧親
打冷顫	打冷震
打劫	爆夾	爆格	騎劫
打勾	打剔
打包袱	執包袱
打叉	打交叉
打叉兒	打交叉
打呵欠	打喊露
打呼嚕	打鼻鼾	扯鼻鼾
打哆嗦	打冷震	打震
打哈欠	打喊路	放飛蚊
打嗝	噯氣
打嗝兒	打噎	打思噎
打噴嚏	打乞嗤
打地基	打樁
打垮	打低
打如意算盤	諗縮數
打存摺	打簿
打寒顫	打冷震
打小報告	督背脊
打小抄	出貓	出貓仔	超技術
打小算盤	諗縮數
打屁股	打屎窟
打情罵俏	放生電	放電
打手	打仔	馬仔
打手心	打手板
打打雜	睇頭睇尾
打扮	執正	執正啲	扮靚	裝身
打扮得光鮮	身光頸靚
打扮得帥	扮靚仔
打扮得很漂亮	執到正
打扮得漂亮	扮靚
打扮得漂亮一點	執正啲
打拳	打功夫
打掃房子	執屋
打撲克	打披
打撲克牌	玩啤牌
打擊	單單打打
打擊別人以抬高自己	踩低人哋，抬高自己
打擺子	發冷
打擾	打攪	滾攪	阻	騷擾
打擾了	打攪晒	滾攪晒	騷擾晒
打擾你一下	阻你一陣
打擾你了	打攪晒
打攪	滾攪	騷擾
打敗	砌低
打架	交	打交
打架殺人	打打殺殺
打柴	斬柴
打格子	間格
打桌球	打枱波
打榧子	打個響指
打槍	燒槍
打橫拉	趟
打死	打瓜	𢷮冧
打死結	打死纈
打毛衣	織冷衫
打氣	泵氣
打氣筒	單車泵	氣泵
打滑	跣
打滾	碌	碌地	碌地沙
打濕衣服	濕身
打火機	火機
打烊	收舖	閂舖
打球	打波
打發時間	迆	迆吓
打的	截的士	截車	搭的士
打盹兒	瞌眼瞓
打瞌睡	瞌眼瞓	釣魚
打瞌睡睡著	瞌著
打瞌睡睡著了	瞌著咗
打破	打爛	打穿
打破沙鍋問到底	打爛砂盆問到篤
打破頭	打崩頭
打算	想話	打預	諗住
打算怎麼樣	噉又點
打算怎麼著	打算點啫
打算進去	預	預咗
打結	打纈	綁纈
打群架	劈友	開片
打耳光	摑
打聽價格	格價
打聽消息	收風
打腫臉充胖子	充大頭鬼
打落水狗	趁佢病，攞佢命
打著火	撻	撻車
打著火了	撻著
打補釘	補𤶸
打西洋拳	打搏成
打賭	輸賭
打車	搭的	搭的士
打退堂鼓	縮沙	褪舦
打通	打穿
打醒精神	醒定定	醒醒定定
打錯了電話	搭錯線
打鐵	𢱕鐵
打閃	閃電
打開了點火裝置	撻著
打開水	冲滾水
打開視野	開眼界
打開點火裝置	撻
打隔斷	橺房
打雜的	散仔
打雷	行雷
打電動	打機
打電話	call	傾電話	撥個輪
打電話聊大天	煲電話粥
打電話聊天	煲電話粥
打領帶	打𧘹
打領結	打煲𧘹
打顫	打冷震
打馬拉松電話	煲電話粥
打鬼主意	出術
打麻將	打牌	打麻雀	搓雀	搓麻雀	砌	竹戰
打麻將的伴兒	麻雀腳
打鼾	打鼻鼾	扯鼻鼾
扔	抌	掉	掟	揈	擗	𢱕
扔下	丟低	抌低	拋低	掉低
扔下來	丟低	拋低
扔了	抌咗	掉咗	擗咗
扔了也沒有人撿	抌咗都冇人執
扔到一邊去	擗開
扔到街道上	抌落街
扔掉	抌	擗
扔掉了	抌咗
扔球	掟球
扔遠一點	抌遠啲
扔開	抌開
托盤	薦盤
托著	豆住
托褔	托賴
扛	孭	托	擔
扛不起	孭唔起
扛得起	孭得起
扛槍	托槍
扛著	佗住
扛鋤頭	擔鋤頭
扣	仆轉	扱	摱	笠	纊
扣上	纊埋
扣不上	扣唔埋
扣子	衫鈕	鈕
扣得很緊	笠實	笠實晒	笠緊
扣扳機	摱雞
扣眼	紐門
扣籃	入樽
扣著	笠住
扭	屈	擰轉
扭傷	屈親	戾	扭親
扭傷了	扭親
扭傷了手	屈親隻手
扭傷了腰	屈親條腰
扭傷了腳	屈親隻腳	扭親隻腳
扭傷了腳了	拗柴
扭動	扭喐
扭屁股	扭屎窟
扭扭捏捏	扭扭擰擰	扭擰
扭捏	扭擰
扭緊	扭實	擰實
扭轉	厲	戾
扭轉臉	擰轉面
扭過臉來	擰轉面
扭過臉去	擰歪面
扭過頭來	擰個頭過嚟	擰過頭嚟
扭頭	擰轉頭
扮傻	詐傻扮懵
扮家家酒	扮煮飯仔
扮成	扮到
扯	嗲	擝
扯平	攪和
扯斷	擝斷
扯破	擝爛
扯開嗓子大哭	喊到拆晒天
扯開嗓門拼命喊	擘大喉嚨嗌
扳	摱
扳子	士巴拿
扳手	士巴拿
扳機	雞
扳胳膊	拗手瓜
扶	摱
扶正	坐正
批評	唱	彈
找	抄	搵
找不到	搵唔到	搵唔翻
找不回	搵唔翻
找不開	暢唔開
找事	嫽交打
找人	嗌人	搵人
找人家的便宜	搲著數
找人幫忙	搵人幫手
找什麼	搵乜嘢
找份兼職	炒更
找位子	搵位
找位置	搵位
找位置坐	搵位坐
找便宜	搵著數
找倒楣	搏拉
找倒霉	搏拉
找出	搵出
找出來	搵出嚟
找到	搵到
找回	搵翻
找回來	搵得翻
找回錢	找數
找工作	搵嘢做	搵工
找房間	搵房
找換	找贖	贖錢
找替槍	使橫手
找材料	搲料	撲料
找架打	嫽交打
找機會	搵機會
找生活	搵世界
找生計	搵食
找竅門	度橋	諗橋
找素材	搲料	撲料
找老伴	煲老藕
找茬	嫽交打
找草藥	搵山草藥
找誰	搵邊個
找遍	搵勻
找醫生治病	睇病
找野漢子	勾佬
找野男人	勾佬
找錢	找數	找贖	贖錢
找錯了門	錯蕩
找開	暢
找零錢給別人	暢錢
找飯碗	搵兩餐	搵兩餐晏仔	搵食	搵餐晏仔食	搵餐飯食
承受壓力	受力
承受重力	受力
承受重壓	受力
承建商	判頭
承担罪責	孭飛
承擔	孭
承擔不了	孭唔起
承擔債務	孭債	孭數
承擔責任	孭上身	孭飛
承擔重要的工作	孭重飛
承擔開支	孭數
技癢	手痕
技能	散手
技藝差的人	魚腩
技術	料
技術長	技術總監
抄下	抄低
抄下來	抄低	記低
把	將	拃	棚
把…攆走	趕…扯
把人攆走	趕人扯
把人趕走	趕人扯	趕扯
把什麼都攬在自己身上	孭上身
把他告到底	告到佢甩褲
把你告到底	告到你甩褲
把兒	椗
把大衣披上	摟翻件褸
把子	耳
把字拼錯	串錯字
把對方打敗	拼沉
把引擎關掉	熄匙
把情況都說出來	爆料
把手交叉在胸前	繑住手	繑手	繑起對手
把手弄破了	整損手
把手錶脫下來	除手錶
把扣子縫上	釘翻粒紐
把握	把炮	揸拿
把木材鋸成板子	鎅板
把東西收拾好	執齊啲嘢	攞齊啲嘢	攞齊嘢
把柄	痛腳
把機器關掉	熄機
把水龍頭擰緊	擰實水喉
把汽車拆成零件	劏車
把沒用的東西扔掉	掉嘢
把窗戶關上	閂窗
把腳跟提起來	䟴高	䟴高腳
把臉擦乾淨	抹乾淨個面
把蓋子蓋好	扱實隻蓋
把蚊帳掛起來	落蚊帳
把衣服脫得精光	剝光衫褲	剝光豬
把褲子往上提溜	優翻條褲
把車剎住	掣住架車
把那些都算上	計埋
把錢攢下來	積埋啲錢
把門撐著	𢷮住度門
把門踢開	𨅝開度門
把門踹開	𨅝開度門
把門蹬開	𨅝開度門
把門關上	閂埋度門	閂埋門
把雞養膘	槽雞
把頭包扎起來	紮住個頭
把風	䀹水	睇水
把鵝養膘	槽鵝
抒情歌	冧歌
抓	拉	捉	揦	揸	搲	摱	肴
抓住	捉住	揦住	揸實
抓住時機	揸住時機
抓住麥克風	揸住支咪
抓個正著	捉到正
抓到	捉到
抓小辮子	揸痛腳
抓工業	揸工業
抓得很緊	揸到實
抓毛絨	fee士	搲毛
抓牢	揸實
抓癢	搲痕	肴痕
抓破	搲損	搲爛	搲花	肴損
抓破了	肴損咗
抓緊	捉實	捉緊	揸到實	揸實
抓緊時間	揸緊時間
抓腋下	擳胳肋底
抓草藥	執山草藥
抓藥	執茶	執藥
抓賭局	𢫏賭
抓辮子	揸痛腳
抓農業	揸農業
抓鏡頭	攞景
抓鬮	執籌
投	掟
投下	拋低
投下來	拋低
投保險	買燕梳
投合	啱feel	啱偈
投擲	掟
投機	啱feel	啱key
投機倒把	炒買炒賣
投機取巧的人	精仔
投籃	入樽
投遞信件	派信
抖	䟴
抖動	䟴	扽
抖抖威風	發吓姣氣
抖腿	䟴䟴腳	䟴腳
折	拗
折扣	折頭
折斷	拗斷
折疊	拗
折疊傘	縮骨遮
折騰	炮製
披	摟
披上	摟翻
披薩餅	pizza
抬	覘	𩓥
抬杠	拗頸
抬槓	頂頸
抬起頭來	覘高個頭
抬轎子	托大腳
抬頭	𩓥頭	𩓥高頭
抱	攬
抱孫子	抱男孫
抱得很緊	攬到實	攬到實晒
抱怨	怨	怨唱
抱枕	攬枕
抱窩	哺竇
抱窩母雞	哺竇雞	哺竇雞乸
抱窩雞	哺竇雞
抱緊	攬實
抱著	攬住
抱起來	擸
抵制	杯葛
抵押	按	按揭
抵押貸款	按揭
抵賴	奸貓	奸賴	賴貓
抵達	到埗	抵埗
抹布	抹枱布
押	按
押金	保證金	按金
抽	吹	撍	泵	縮水
抽出來	撍出嚟
抽取	撍
抽屜	櫃桶
抽打	[拂]	藤條炆豬肉
抽抽搭搭	嗍鼻
抽水	泵水
抽水車	泵車
抽烏龜	潛烏龜
抽煙	煲煙	食煙	食煙仔
抽籖	執籌
抽芽	標芽
抽起	掅
抽香煙	食煙仔
抽鬼	潛烏龜
抽鬼牌	潛烏龜
抿嘴	[喵]	喵嘴
拆卸腳手架	拆棚架
拆台	擘面
拆得開	拆得開，鬥唔埋
拆穿	督爆
拆開賣	散賣
拇指	手指公
拈花惹草	攪三攪四	滾
拉	擝
拉下	拉低
拉下來	拉低
拉倒	罷就
拉傷	拉親
拉屎	屙屎	屙臭臭	屙茄	爆石	開大
拉扯不斷	雞啄唔斷
拉斷	擝斷
拉皮條的	龜公
拉稀	屙	屙肚
拉緊	擝實	擝衡	衡
拉肚子	屙	屙肚	肚屙
拉關係	認親認戚
拉隊伍	班
拉雜	林沈
拋下	丟低	拋低
拋下來	丟低	拋低
拋售	掟貨
拋棄	掉
拋眉眼	放生電	放電
拋錨	死火
拋錨了	死咗火
拌	撈
拌勻	攪勻
拌嘴	頂頸
拌飯	撈飯
拌麵	撈麵
拍	影
拍下	影低	拍低
拍不到	影唔到
拍張照片	影張相
拍手叫好	拍爛手掌
拍攝	攝錄
拍照	影相
拍片	做電影	拍戲
拍老闆馬屁	托老闆
拍電影	做電影	拍戲	拍片
拍馬屁	托	托大腳	擦鞋	𦧺屎窟
拎	掅
拎起	掅起
拐彎	掟彎
拐杖	士的
拐棍	士的
拒絕幫助	托手踭
拔	撍	擝
拔出	撍	擝出
拔尖兒	標青
拔槍	擝槍
拔河	拉大纜	擝繩
拔草	擝草
拔豬毛	撍豬毛
拔鬍子	擝鬍鬚
拖下	拖低
拖下來	拖低
拖延時間	捱時間	揼時間
拖把	地拖
拖拖拉拉	唔嗲唔吊
拖時間	姿整
拖沓	[湆]	湆懦
拖累	佗累	佗衰
拗口	咬口	繑口	繑脷
拘束	思思縮縮	思縮
拚命	拚
拚命幹	死咁做
拚命讀書	死咁咪
招	挹
招人恨	乞人憎	得人憎
招來是非	周身蟻
招來麻煩	惹屎上身	揦屎上身
招兒	橋
招呼	call
招引	勾
招待	招呼
招待不周	招呼唔到
招待客人	招呼人客
招惹	嫽	惹
招惹了許多麻煩	攪到一身潺
招手	挹手
招搖	大模斯樣	招積
招搖撞騙	㨘牛王	㨘黃魚
招風耳	兜風耳
招風耳朵	兜風耳
拜懺	打齋
拜托	托賴
拜託你	好心你
拜認的	契
拮据	手緊	水緊
拳術	功夫
拳頭	拳
拴	纊
拴上	纊埋	閂
拴上門	閂埋度門
拴住	纊住	褦
拼	串	搏
拼上老命	搏晒老命
拼不上	拆得開，鬥唔埋	鬥唔埋
拼了	搏過
拼了老命	搏晒老命
拼凑模型	砌模型
拼合	鬥
拼命	搏	搏命	搏晒命	搏殺	搏老命	落足	起勢
拼命吃	擦餐勁	擦餐懵	擦餐飽
拼命地	搏晒老命噉	死咁	起勢	起勢噉
拼命地賺錢	搲銀
拼命地走	起勢行
拼命地跑	搏命噉走
拼命守成平局	搏和
拼命幹	起勢噉做
拼命撐著	死撐
拼命節省	死慳死抵
拼命補習	惡補
拼命遊說	落足嘴頭
拼單詞	串字
拼圖	砌圖
拼字	串字
拼寫	串
拼得太兇了	搏死
拼搏	搏
拼搏到底	搏到盡
拼模型	砌模型
拼死	搏死
拼死拼活	捱生捱死
拼殺	搏殺
拼盡全力	搏到盡
拼砌	鬥
拼老命	搏晒命	搏老命
拼裝	鬥
拼錯	串錯
拼錯單詞	串錯字
拼錯字	串錯字
拽	剒	擝
拽鬍子	擝鬍鬚
拾	執
拾人涕唾	學人口水溦	跟人口水溦
拾人牙慧	執人口水溦	學人口水溦	跟人口水溦
拿	拎	揦	揸	搦	攞	豆
拿下來	攞落嚟
拿不了主意	揸唔到主意
拿不出來	拎唔出
拿不動	搦唔喐
拿不定主意	心多多	心大心細	攞唔定主意
拿不穩	揸唔穩
拿主意	揸主意	揸弗	揸軚
拿了	攞走
拿人出氣	搵人出氣
拿人撒氣	搵人出氣
拿他沒辦法	吹佢唔脹	咬佢唔入	攪佢唔掂
拿來	攞嚟	畀嚟
拿來看看	攞嚟睇睇
拿個牌兒掛號	攞個籌掛號
拿出	拎出
拿出來	拎出嚟	擺出嚟	攞出來
拿出去	拎出去	搦出去
拿到	攞到
拿去	攞去
拿回	攞翻
拿回來	攞翻
拿回去	拎翻去	攞翻去
拿回家	拎翻屋企
拿在手裡	揸上手
拿我出氣	搵我出氣
拿我撒氣	搵我出氣
拿手	耍家
拿手的	殺食
拿掉	攞走
拿槍	揸槍
拿照相機拍照	揸機影相
拿筷子	揸筷子
拿紅包	豆利是
拿著	揸住
拿走	搦走	攞走
拿起	攞起
拿過來	搦過嚟	攞過嚟
拿雞毛撣子打人	藤條炆豬肉
持槍	揸槍
指南針	羅經
指印	手指模	指模
指揮	揸軚	擔大旗	笛
指望	指擬
指望你了	指擬你
指甲	手指甲	手甲
指甲刀	指甲鉗
指甲剪	指甲鉗
指甲剪子	指甲鉗
指節銅套	鐵蓮花
指節銅環	鐵蓮花
指紋	手指模	指模
指責	彈
指靠賭錢騙人為生的人	賭棍
按	撳
按下鼠標	click
按你的意思	計你話
按制度	執正
按原則	執正
按慣例	循例
按我的意思	計我話
按指印	打手指模	打指模
按摩	鬆骨	𢱕骨
按摩女郎	骨女	骨妹	𢱕骨妹
按摩院	骨場	𢱕骨場
按時	依時	依時依候
按照慣例	循例
按理說	計正
按脈	揞脈
按規矩	執正
按道理	計正
按鈕	撳掣
按錯電鈕	撳錯掣
按門鈴	撳鐘	撳門鐘
按電梯	撳猎
按電鈕	撳掣
按電鈴	撳唥鐘
挎手提包	挽手袋
挎著	挽
挑	揀	擔
挑不動	擔唔喐
挑不起	擔唔喐
挑來挑去	左揀右揀，揀個爛燈盞
挑剔	揀擇	醃尖
挑剩的東西	籮底橙
挑吃	揀飲擇食	擇食
挑吃挑喝	揀飲擇食
挑嘴	嘴刁
挑大樑	孭重飛	擔大旗
挑字眼兒	捉字蝨
挑撥是非	嫽是逗非	嫽是非
挑水	擔水
挑起一個問題來氣人	嫽嫽吓
挑起事端吵架	嫽交嗌
挑逗	嫽	惹
挑選	揀	揀擇
挑釁	嫽交嗌
挑食	揀飲擇食
挖	掘	撩	撬
挖出	掘出
挖土機	剷泥車	雞頭
挖牆腳	撬墻腳
挖耳垢	撩耳屎
挖苦	嘥	潤	瘀	諦
挖走	撬走
挖鼻孔	撩鼻屎
挨一頓藤條兒抽打	藤條炆豬肉
挨個兒來	輪住嚟
挨家挨戶	逐家逐戶
挨家挨戶地	逐家逐戶噉
挨罵	食貓麵
挨雞毛撢子	藤條炆豬肉
挨餓	紮炮	餓親
挪	褪
挪過去	褪過去
振作	爽利
挺	幾	躽	頂
挺…的	鬼死咁…
挺便宜	幾平
挺嚇人的	幾得人驚
挺好	幾好
挺好的吧	幾好吖嘛
挺得住	抵得
挺快	幾快
挺胸	躽胸
挺著個大肚皮	躽起個大肚腩
挽回	摱
挽救	箍煲
挽起袖子	押高衫袖
捅	督	錐	𢷮
捅了大婁子	乃大鑊	乃鑊	大鑊	揩鑊
捅個窿	督穿個窿
捅婁子	倒米
捅破	督穿
捆	紮
捆好	抓實	紮實
捆得結結實實的	綁到實
捆扎	抓
捆牢	紮實
捆結實	紮實
捆綁	抓
捆緊	紮實
捆著	抓住
捉姦	揸黃腳雞
捉弄	整古
捉迷藏	伏兒人	伏匿匿	捉伊人	捉兒人
捎個口信	搭句說話
捎話	搭句說話
捏	捻	搣
捏一把冷汗	標冷汗
捏一把汗	抹一額汗
捏了一把冷汗	標晒冷汗
捏了一把汗	抹咗一額汗
捏破了	捻爛咗
捏著	揸手
捏造	安	生安白造
捏閘	揸手掣	揸掣
捐款	善款
捐錢辦善事的人	善長仁翁
捕	拉
捕鼠器	老鼠夾
捧場	抬轎
捧場者	擁躉
捨不得	唔捨得
捱	抵
捱一頓臭罵	畀鬧到一戙都冇	畀鬧到一隻屐	畀鬧到死死吓
捱不了	唔捱得
捱不了苦	唔捱得苦
捱凍	抵冷
捱罵	畀人鬧
捱餓	抵肚餓	捱肚餓
捱餓受凍	捱飢抵冷
捲	押
捲尺	拉尺
捲心菜	椰菜
捲起褲管	押高褲腳
捲起褲腿兒	押高褲腳
捶	抌	𢱕
捶打	𢱕
捶打身體	鬆骨
捶捶腰	𢱕吓條腰
捶擊	𢱕
捶胸	抌心口
捶胸頓足	捶胸䂿腳
捷徑	近路
捷泳	捷式
掃一眼	擸一眼	睄
掃他一眼	睄佢一眼
掃墓	拜山
掃帚	掃把
掃帚星	掃把星
掃興	冇癮
掃視	擸一眼
掃過來	掃埋嚟
掉	甩	跌	𢱕
掉下	跌落
掉下來	跌落嚟
掉下去	跌落去
掉了	掉咗	甩咗
掉到地上	跌落地
掉在地上也沒人要	執到都喊三聲
掉色	甩色
掉褲子	甩褲
掉頭	兜轉頭	屈尾十	翻轉頭
掌握	揸手
掌櫃	事頭	企櫃面	坐櫃面
掌權	揸弗	揸莊
掌權人	揸弗人
掌管	揸手
掌聲如雷	拍爛手掌
掌舵	把舦	揸弗	揸舦	揸軚
掏	扲	撩
掏口袋	扲袋
掏槍	擝槍	擝炮
掏耳朵	撩耳	撩耳仔
掏腰包	扲荷包
掏錢包	扲荷包
掏零錢	扲散紙
掏鳥窩	扲雀仔竇
掐	捻
掐死	捻死
掐脖子	捻頸
排	棚
排到最前面的位置	排頭位
排叉兒	蛋饊
排在最末尾	排孻屘
排場大	大陣仗
排大隊	排長龍
排字	執字粒
排插	拖板	拖蘇
排擋	波箱
排最後一名	排第屘
排檔	波
排毒	散毒
排氣管	死氣喉
排洩	屙
排隊	輪
排隊排在最末尾	排隊排孻屘
排隊等候	輪候
排隊購買	輪
掖	押	攝
掖尿布	押屎片
掖蚊帳	攝蚊帳
掙錢	搵銀	搵錢
掙錢餬口	搵食
掙飯吃	搵兩餐	搵兩餐晏仔	搵食	搵餐晏仔食	搵餐飯食
掛	纊
掛上	纊埋
掛在半空中	半天吊
掛念	掛住	掛望	記掛
掛斷電話	收線
掛旗	扯旗
掛歪了	掛歪咗
掛著	佗住	纊住
掛號	攞籌
掛號信	擔保信
掛蚊帳	晾蚊帳
掛錶	砣錶
掛電話	收線
採	摘
採伐木柴	斬柴
探井蓋	沙井蓋
探望	探
探頭看	䁓
掣肘	托手踭
接下來	跟住落嚟
接下茬	搭嘴
接不上嘴	甩嘴
接受	受落
接受下來	受落
接受不了	接受唔到
接吻	咀嘴	咬口脣	啜嘴	打茄輪	打車輪	激嘴
接水管	駁水喉
接洽	斟
接生	執仔
接生婆	執仔婆
接納	受落
接線	駁線
接線板	拖板	拖蘇
接著	跟住	跟手	連隨
接著處理	跟進
接近	挨近	近住
接近年底	挨年近晚
接近歲晚	挨年近晚
接電話	聽電話
接駁	駁
接骨	駁骨
控制不了	控制唔到
控告	告
推	㧬	𢷮
推三阻四	亞吱亞咗
推下	推低
推下來	推低
推下去	㧬落
推人	㧬人
推倒	㧬低	㧬冧	㧬跌
推光頭	剷光頭
推剪	剷
推卸責任	側側膊	卸膊
推土機	剷泥車	雞頭
推推搡搡	推推㧬㧬
推薦	舉薦
推銷員	sales	銷士
推門	㧬門
掩蓋不了	遮唔住
掩蓋不住了	揞唔住
掰橙子	搣橙
掰腕子	拗手瓜
揉	捽	搓
揍	喐	抦	砌	鬆骨
揍扁	㩧濕
揍癟	㩧濕
提	優	拎	挽	掅	搦
提供消息	爆料
提供資料	爆料
提出減免稅款	claim稅
提升級數	升呢
提回去	拎翻去
提審	提堂
提手	挽手	耳
提手提包	挽手袋
提手旁兒	剔手邊
提拔	帶挈
提拿	的
提攜	帶挈
提早	預早
提梁	挽手
提款	撳機	撳錢
提比里斯	第比利斯
提水	挽水
提溜	優	挽	的
提溜起來	的起嚟
提着	拎住
提示	貼士
提示卡	貓紙
提示性信息	貼士
提神	醒神
提筆忘字	揸筆忘字
提著	挽	掅住	搦住
提著一袋東西	掅住一袋嘢
提褲子	優褲
提襪子	優襪
提訊	提堂
提貨單	出水紙
提起	掅起
提起來	掅起身	的起嚟
提起十二分精神	醒定定
提起精神來	醒定定	醒醒定定
提起腳後跟	䟴高	䟴高腳
提起腳跟	䟴高	䟴高腳
提錢	攞錢
提高警踢	醒少少
插	攝
插一嘴	加把口
插嘴	加把口	搭嘴
插尿管	插尿喉
插座	插蘇
插排	拖板	拖蘇
插秧	蒔田
插銷	插蘇頭
插隊	兼隊	打櫼	櫼隊
插頭	插蘇頭
插香	裝香
揚帆	扯𢃇
揚揚得意	讕得敕
揚聲器	大聲公
揚言要打人	喊打喊殺
揚起	滾起
換位	調位
換位子	調位
換位置	調位
換尿布	換屎片
換成	暢
換搭檔	換檔
換衣服	換衫
換零票	暢散紙
握	揸
握著拳頭	揸起拳頭
揩擦	抆
揩油	搏懵	索油
揪心	肉緊
揭瘡疤	捉痛腳
揭發	踢爆
揭短	捉痛腳
揭穿	督爆	踢爆
揭開內幕	爆內幕
揮手	挹手
揮金如土	大使
揮霍	亂揈	亂揈錢	大使	荷包倒吊	讕使
揮霍無度	大使
揮霍錢財	荷包亂揈	荷包倒吊
援助	幫拖
揶揄	攞景
搋子	廁所泵
搌布	抹枱布
損人	窒人
損傷	損
損失了一半	損手爛腳
損毀	瘀
搓	㨘	捽
搓板	洗衫板
搓汗垢	捽老泥
搓污垢	捽老泥
搓洗	㨘
搓腳	捽腳
搔	搲	肴	𢯎
搔癢	肴痕
搖	擰	𢳆
搖來搖去	岌岌貢
搖來擺去	吊吊揈
搖動	擰動
搖搖晃晃	岌岌貢
搖搖欲墜	岌岌貢
搖擺	挹
搖晃	岌	岌岌貢
搖桿	手掣
搖粒絨	fee士	搲毛
搖頭	揈頭	擰晒頭	擰頭
搖頭丸	E仔	揈頭丸
搖頭晃腦	擰頭擰髻	頭揈揈
搗亂	攪攪震	滾紅滾綠	踩場
搗亂的人	倒米壽星	倒米壽星公
搗蛋	倒米	反斗	攪嘢
搗蛋的人	倒米壽星	倒米壽星公
搗蛋鬼	反斗星
搗鬼	扭計
搛菜	挾餸
搜	抄
搜刮	擸
搜刮一空	擸光晒
搜尋	抄
搜查	抄
搜羅	擸
搜身	抄身
搜集材料	搲料	撲料
搞	攪
搞party	攪派對
搞事的	攪屎棍
搞事者	攪屎棍
搞什麼鬼	整乜嘢鬼	整鬼整馬
搞什麼鬼？	攪邊科呀
搞到一起	撈
搞垮	做低	打低	踩低
搞壞	攪堝
搞外快	秘撈
搞大了	玩大咗
搞女人	滾
搞好	攪妥
搞定	攪掂
搞得	攪到
搞得一塌糊塗	攪到雞毛鴨血
搞得亂七八糟	攪到立立亂
搞得亂糟糟的	攪到立立亂
搞法	攪作
搞派對	攪派對
搞混	撈亂
搞混了	撈亂晒
搞無米之炊	煲冇米粥
搞破壞	攪攪震
搞砸	扠堝	攪瘀	整衰
搞砸了	整衰晒	殽晒框	殽框
搞突擊	惡補
搞笑	攪gag	攪嘢	攪笑
搞糟	扠堝	攪堝	攪瘀	整衰
搞糟了	殽晒框	殽框
搞糟糕	攪瘀
搞花樣	攪花臣
搞誤會	擺烏龍	擺老烏
搞錯	攪錯
搞錯了沒有	有冇攪錯
搞鬼	整鬼
搞點新意	攪攪新意思
搧風耳朵	兜風耳
搬	擔
搬兵	班兵
搬凳子	擔凳仔
搬回	搬翻
搬回來	搬翻嚟
搬回去	搬翻去
搬家	搬屋	搬竇
搬弄是非	學是學非	攪風攪雨	𢷮鬼
搬救兵	班馬
搬桌子	擔枱擔凳
搬椅子	擔凳	擔凳仔	擔枱擔凳
搬進	搬入
搬運工	咕哩
搭	摱
搭上	撻著
搭中巴	搭van仔
搭乘出租車	搭的士
搭伙	搭食
搭伙一塊兒去	合埋一齊去
搭便車	搭順風車
搭建腳手架	搭棚
搭救	打救
搭檔	拍乸	拍檔
搭腳手架	搭棚
搭著肩	搭住膊
搭著肩走路	搭住膊噉行
搭設腳手架	搭棚
搭配	褦
搭配著吃	食…送…
搭關係	搭路
搭電梯	搭猎
搭順路車	搭順風車
搭飯	搭食
搶	劫	湧	老笠
搶不過他	唔夠佢爭
搶位子	爭位企
搶光	湧晒
搶劫	老笠	騎劫
搶回	搶翻
搶著	爭住
搶著吃	爭住食	爭食
搶購	掃貨
搶購便宜貨	擸平嘢
搶購東西	擸嘢
搶鏡頭	搶鏡
摀	揞
摀住	揞住
摀住傷口	揞住個傷口
摀住嘴巴	揞口
摀住耳朵	揞住對耳
摀得嚴嚴密密的	揞到實
摀得很緊	揞到實
摀緊	揞實
摀著	揞住
摀著嘴偷偷笑	揞住嘴笑
摀著嘴巴笑	揞住嘴笑
摀著耳朵	揞住對耳
摀著雙眼	揞眼
摁	撳
摁指印	打手指模	打指模
摁釘	撳釘
摁電鈕	撳掣
摁電鈴	撳唥鐘
摑	𢫏
摑一個耳光	𢫏一巴掌
摑他一個耳光	𢫏佢一巴掌
摑你一個耳光	𢫏你一巴掌
摔	仆	撻	碌	笪	跣	躀	𢱕	𢴈
摔下來	碌落嚟	笪落地	𢴈落嚟
摔下去	碌落去
摔下地	笪落地
摔了一交	跣咗一跤
摔了一跤	笪親	跣低	跣咗一跤	躀咗一跤
摔了下來	笪低
摔了個半死	笪餐死
摔倒	仆低	碌	笪	跌親	躀低	𢴈
摔傷了	笪傷
摔壞了	跌爛
摔得暈頭轉向	跌到七彩
摔死了	笪死
摔破	跌爛
摔破頭	跌崩頭
摔著了	仆親
摔跤	跌跤	跣跤	躀	躀跤
摘下眼鏡	除低眼鏡
摞	㨆	戙
摟	擸	攬
摟抱	攬
摟摟抱抱的	攬身攬勢
摟著	攬住
摩托車	綿羊	綿羊仔	電單車
摩托車手	鐵騎士
摳	小器	摱
摳字眼兒	捉字蝨
摳搜	小器
摳門兒	小器
摳鼻孔	撩鼻屎
摸	玷
摸不著頭腦	一頭霧水
摸底	探盤
摸清底細	起底
摸著石頭過河	見一步，行一步	見步行步
摸過去	趟
摻合	摳
摻合在一起	兩摳
摻和在一起	摳埋
摻雜	摳
摻雜在一起	摳	摳埋	摳摳埋埋
撂挑子	卸膊
撅	屈
撅斷了	屈斷咗
撇一下嘴	喵喵嘴
撇嘴	[喵]	喵嘴
撇撇嘴	嘴喵喵	𠴕嘴𠴕舌
撈不到油水	冇啖好食
撐	掙	頂
撐不住	頂唔住
撐住	頂住
撐得住	頂得住
撐得住場面的	殺食
撐腰	撐
撐著	頂住
撐起	托起
撒	糝
撒嬌	嗲	嬌嗲	耍花槍	詐媽嬌	詐嬌	詐嬌弄嗲
撒尿	交水費	小便	屙尿	屙殊殊	揸水	放低二兩	放水	殊殊
撒手不管	冇眼睇
撒氣	漏氣
撒胡椒粉	糝古月粉
撒胡椒麵兒	糝古月粉
撒芝麻	糝芝麻
撒謊	放葫蘆	講大話
撒野	狼戾	發啷厲	發爛渣	發茅	矛	矛賴	踩場
撓	搲	擳	肴
撓癢癢	擳	肴痕
撓胳肢窩	擳胳肋底
撓頭	肴頭	肴頭殼
撕	搣
撕破	搣爛
撕破面子	擘面
撕開	搣開
撞傷了	撞親
撞傷了頭	扻親個頭
撞擊	扽手踭
撞死	車死
撞球	士碌架
撞過來	走埋嚟
撞騙者	白撞
撥	減
撥弄是非	嫽是逗非
撥錯了號	打錯電話
撩撥	惹
撫心自問	問心嗰句	講心嗰句
撮垃圾	抔垃圾
撲克牌	啤	披牌
撲克牌中的“2”	弟
撲滿	錢罌
撿	執
撿人家的剩貨	執二攤	揸二攤
撿人家破爛	執二攤
撿便宜	執到著數
撿到	執到
撿到便宜	執死雞	執死雞仔	執雞
撿到好東西	執到寶	執到著數
撿回	執翻
撿垃圾的	垃圾佬
撿現成兒	執死雞	執死雞仔	執雞
撿現成的	執死雞	執死雞仔	執雞
撿起	執起
撿起來	執起嚟
擁抱	攬
擁擠	屈質	擠擁	擠逼	逼	逼人
擁護者	擁躉
擂	𢱕
擅長	耍家
擅闖的	白撞
擊頭黨	㩧頭黨
擋	遮	阻
擋住	遮住
擋板	拼
擋著	遮住	阻住
擋風外衣	風褸
操心	憂心	霎氣
擔心	慌怕	憂	憂心	發驚青	驚住	驚青	驚青青	驚驚青青
擔憂	憂
擔負責任	跟
據悉	有傳
據為已有	汁都撈埋
據說	據講
據點	竇口
擠	扤	挾	捻	掙	瀄	逼
擠乾	捻乾
擠來擠去	逼嚟逼去
擠公共汽車	逼巴士
擠公車	逼巴士
擠出	瀄
擠出水分	揸水
擠垮	踩低
擠壓	瀄
擠得水洩不通	逼到冚晒
擠得緊緊的	逼冚晒
擠得要命	逼到鬼噉
擠牙膏	瀄牙膏
擠牛奶	揸奶
擠眉弄眼	䁪眉䁪眼	單眼
擠眼	單眼
擠破了	捻爛咗
擠腳	挾腳
擠進去	逼入去
擠過來	逼過嚟
擦	抆	抹	捽	揩	撟
擦不掉	捽唔甩
擦乾淨	抹乾淨
擦傷	擦親
擦地板	抹地	拖地
擦屁股	抆屎
擦手	抹手
擦掉	擦晒
擦桌子	抹枱
擦桌布	抹枱布
擦汗	撟汗
擦玻璃	抹窗口
擦眼淚	撟眼泪
擦破	擦損
擦窗子	抹窗口
擦臉	抹面
擦身	抹身
擰	厲	扭
擰斷	擝斷
擰緊	扭實	擰實
擰緊水龍頭	擰實水喉
擰耳朵	扭耳仔
擱	躉
擱下	躉低
擱在地上	躉落地
擱涼	攤凍
擴展名	副檔名
擴音器	咪高峰	大聲公
擺下	擺低
擺下來	擺低
擺動	揈
擺在	坐喺	放喺
擺姿勢	擺甫士
擺攤兒	擺檔	擺檔口	擺街邊
擺攤子	擺檔	擺檔口
擺攤賣菜的	街市仔
擺放	擺
擺架子	擺晒款	擺款	詐型	高竇
擺桌子吃飯	開枱食飯
擺樣子	擺款
擺派頭	擺款
擺脫麻煩	過橋
擺譜兒	擺款
擺賣	擺街邊
擺酒席	擺酒
擺闊氣	讕闊佬
擾頓飯吃	黐飯餐	黐餐
攀爬	擒
攀登	擒
攀登上樹	擒樹
攔出租車	截的士	截車
攔著	阻住
攔路搶劫	劏死牛
攙和	摳
攙和在一起	對摳	摳	摳埋
攝像	攝錄
攝像機	攝錄機
攝影作品展覽	沙龍
攝影師	影相佬
攢	儲
攢積	儲
攢起來	儲埋
攢錢	儲錢	積錢
攤	坺	檔	檔口
攤位	檔位	舖位
攤兒	攤檔	檔
攤子	攤檔	檔	檔口
攤牌	曬冷
攤點	攤檔
攪	撈
攪party	攪派對
攪和	[拂]
攪和雞蛋	拂雞蛋
攪打	[拂]
攪拌	攪勻
攬取	擸
支持	十扑	撐	頂
支持到底	撐到恆
支持者	擁躉	粉絲
支撐	撐	頂
支撐架	棚架
支票	仄	仄紙	銀仄
支起腿	戙起隻腳
收下	收低
收不回來	收唔翻
收伞	收遮
收傘	笠遮
收入	入息
收入很低	入息好奀
收到交通違例告票	食牛肉乾
收到消息	收到風
收到罰單	食牛肉乾
收到罰款通知書	食牛肉乾
收回	收翻
收回來	收翻
收場	埋尾	收科
收好	收埋
收尾	埋尾	煞科
收尾工作	手尾
收屍	執屍
收帳	收數
收房租的老太太	收租婆
收拾	執	執拾	炮製
收拾一下床鋪	執吓張床
收拾乾淨	執拾乾淨
收拾好	執定	執齊
收拾好行李	執拾好行李	執齊行李
收拾床鋪	執床
收拾得整整齊齊	執到正
收拾房間	執房
收拾桌子	執枱
收拾死屍	執屍
收拾殘局	執手尾	執蘇州屎
收拾爛攤子	執蘇州屎	跟手尾
收拾碗碟	執碟
收拾碗筷	執碟
收拾行李	執包袱	執行李
收拾起來	收埋
收據	收條
收攏	擸	笠
收攤	收檔
收攤兒	收檔
收款台	收銀台
收款員	收銀員
收看	收睇
收穫豐盛	盤滿缽滿
收舊貨的	收買佬
收藏	收埋	柄
收藏起來	收收埋埋
收賬的	收數佬
收起來	擸	擸埋
收起來吧	收檔罷啦
收錢	收數
收集	儲
收集好	執齊
改主意	褪軚
改口	反口
改天	第日	第時
改天晚上	第晚
改換	改轉
改換工作單位	轉工
改日	第日
改正	改翻
改行	轉行
改變立場	轉軚
放	坐	擠	躉
放下	坐低	擺低	放低	躉低
放下來	擗開	擺低
放下心事	心息
放下心頭大石	安樂晒
放不下	放唔低
放入	入
放在	坐喺	擠喺	放喺
放在地上	放喺地下	躉落地
放在桌面	擠喺枱面
放屁	屙屁
放心	安樂	放膽
放心做	放膽做
放心去	放膽去
放映	上畫
放映期	檔期
放暑假	唞暑
放棄	放䠋
放槍	燒槍
放涼	攤凍
放潑	發爛渣
放炮竹	燒炮仗
放煙火	放煙花
放爆竹	燒炮仗
放牛	看牛
放著	擠住
放蕩	姣
放進	入
放進口袋裡	落袋
放進抽屜	放入櫃桶
放長假	放大假
放鞭炮	燒炮仗
放風	睇水
放風箏	放紙鷂
放馬過來	放馬過嚟
放高利貸	放數	放貴利
放高利貸的人	大耳窿
放鴿子	放飛機	甩底
政客	政棍
故事	故仔
故作神秘	讕神秘
故意	專登	有心	特登	立心
故意出洋相	整古弄怪	整鬼整怪
故意刁難	過唔去
故意氣人	攞景
故意為難	托手踭
故意貶低	嘥
故意跌倒	插水
故鄉	唐山	鄉下
故障了	神咗
效仿	學	學似
效率真高	快過打針
效率高	快過打針
救回	救翻
救火警鈴	消防警鐘
救生圈	救生水泡	水抱
救護車	十字車	救傷車	白車
敗家	獻世
敗家子	亞斗官	亞鬥官	佗衰家	敗家仔	敗家精
敗絮其中	有姿勢冇實際
敗露	爆煲
教室	班房	課室
敢	夠膽
敢做敢當	食得鹹魚就要抵得渴	食得鹹魚抵得渴
散	喪
散亂	散收收
散了架	甩頭甩骨
散了架子	甩頭甩骨
散伙	拆檔	散檔
散戶	老散
散發	派
散銀	碎銀
散開	散
敲	㩧	搉	摼
敲打	㩧	搉
敲擊	摼
敲竹槓	斬到一頸血
敲腦袋	搉頭殼
敲門	拍門
整	成	沓正	炮製	通
整個	成個	通
整個早上	成朝	成朝早
整個星期	成個禮拜
整個翻了天	攪到滿天神佛	滿天神佛
整個買	成個買
整夜	成晚
整天	一日到黑	成日
整天掛在嘴上	開口埋口
整天東奔西走的人	冇尾飛陀
整天苦著臉	苦口苦面	苦瓜乾噉口面	苦瓜噉口面	苦瓜噉嘅面	苦瓜噉面	苦瓜面
整年	成年
整座樓宇的買賣合約	公契
整整	沓正
整整一個小時	成個鐘
整整齊齊	企企理理	四四正正	四平八正
整數	齊頭數
整治	治
整潔	企理
整理房間	執房
整理數據	整資料
整理資料	整資料
整理賬目	做數
整點	沓正
整齊	企理	四正	齊整
敷衍了事	揦揦西西	揦西
數不清	數唔切	計唔清
數位	數碼
數來寶	數白欖	白欖
數字	數碼
數目不對	唔啱數
數目很大	好大數
數目要分明	數還數，路還路
數碼	冧巴
數落	數臭
文件	快勞
文件擴展名	副檔名
文具店	文具舖
文字處理器	文書處理器
文憑	紗紙
文檔	快勞
文章	文
文質彬彬	官仔骨骨
斗	籮
斗膽	沙膽
斗那麼大的字	雞乸咁大隻字
料不到	估唔到	點知
料子	絨
料子大衣	絨褸
料理	打理
料酒	紹酒
斜眼	斜喱眼	蛇喱眼
斜著看人	眼矋矋
斜著眼睛瞪人	眼矋矋
斜著身子	䠋
斤斤計較	扤失
斥罵	數臭
斬殺	劈友
斬首	斬頭
斯斯文文	官仔骨骨
斯洛文尼亞	斯洛維尼亞
新人	新嚟新豬肉
新來乍到	初嚟暴到	初嚟甫到
新來的人	新仔
新元	坡紙
新創意	攪作
新加坡	叻埠
新加坡元	坡紙
新加坡貨幣	叻幣
新同事	新嚟新豬肉
新同學	新嚟新豬肉
新奇有趣	趣怪
新娘	心抱	新人
新幣	坡紙
新年的時候	新年流流
新從內地來香港帶土氣的姑娘	燦妹
新從內地來香港帶土氣的青年	燦仔
新意	新意思
新意思	攪作
新手	初哥	新仔
新款	時款
新款手錶	時款手錶
新貨	新嘢
新郎	新郎哥
新鮮的	新鮮熱辣
斷奶	切奶	戒奶
斷子絕孫	冚家鏟
斷定	睇死	睇白
斷根	斷尾
斷檔	斷市
斷絕關係	斬纜
斷貨	斷市
方便	就腳	順攤
方便鞋	懶佬鞋
方便麵	公仔麵	即食麵
方向盤	車軚	軚	軚盤
方向盤在右邊的汽車	右軚車
方向盤在左邊的汽車	左軚車
方塊	階磚
方塊兒	階磚
方方正正	四四正正
方格紙	格仔紙
方正	四正
方片兒	階磚
方磚	階磚
方臉盤	國字口面
方麵包	枕頭包
於是	於是乎
施展騙術	出貓招
施工升降機	籠猎
施工電梯	籠猎
施肥	壅肥	落肥
旁邊	側便	側邊	隔籬
旁邊不遠的地方	隔籬左近
旁邊兒	側便	側邊
旅行箱	皮喼
旅遊汽車	旅遊巴
旅遊車	旅遊巴
旅館	酒店
旋動	扭	擰
旋緊	扭實	擰實
旋緊瓶蓋	擰實樽蓋
旗袍	長衫
日上三竿	黃朝百晏
日以繼夜	捱更抵夜
日光燈	光管
日子久了	日子耐咗
日子好過	大把世界
日子過得很漫長	日子流流長
日文	㗎文	㗎話
日曆	月份牌
日曆牌	月份牌
日本人	㗎佬	㗎頭
日本少女	㗎妹
日本少男	㗎仔
日班	日更
日用品	日常用品
日積月累	積積埋埋
日落	太陽落山
日語	㗎文	㗎話
日食	天狗食日
早	早晨
早上	晨早	朝早	朝頭早
早上好	早晨
早些時候	較早前	較早時
早先	初時	頭頭
早前	較早前	較早時
早安	早晨
早就	一早	大早
早就去世了	瓜晒老襯
早已	大早
早操	晨運
早料到	預咗
早日康復	快啲好翻
早晚	遲早
早晨	晨早	朝早	朝頭早
早睡	早瞓
早著呢	未有耐
早餐	朝早飯
早點休息	早唞
早點回來	早啲翻嚟
旭蟹	老虎蟹
旮旮旯旯兒	窿窿罅罅
旮旮旯旯的地方	窿窿罅罅
旱冰	滾軸溜冰
旱冰鞋	滾軸溜冰鞋	雪屐
旱季	天時旱
旱螞蟥	山蜞
旱鴨	番鴨
旺	猛
旺季	造
旺季已過	過造
昂	𩓥
昂起頭	頭𩓥𩓥
昂首	𩓥頭
昆蟲	蟲
昇旗	扯旗
明不明白？	你un唔un呀？
明亮	光猛
明信片	甫士咭
明天	聽日
明天早上	聽早	聽朝	聽朝早
明天晚上	聽晚
明天見	聽日再見
明年	出年
明早	聽早	聽朝	聽朝早
明星	星
明晚	聽晚
明澈	通透
明白	un	明	通透
明白該怎麼做	識do	識做
明白過來	醒起
昏暗	翳
易受驚	發驚青	驚青	驚青青	驚驚青青
易壞	化學
易如反掌	易到極	易過借火	易過食豆腐
易學易做的工作	手板眼見工夫
易拉罐	鋁罐
易碎	化學
星元	坡紙
星夜	漏夜
星幣	坡紙
星星	星
星期	禮拜
星期一	禮拜一
星期三	禮拜三
星期二	禮拜二
星期五	禮拜五
星期六	禮拜六
星期四	禮拜四
星期日	禮拜	禮拜日
春聯	揮春
昧著良心	揞住良心
昨天	尋日	琴日
昨天早上	琴朝
昨天晚上	尋晚	尋晚黑	琴晚	琴晚黑
昨晚	尋晚	尋晚黑	琴晚	琴晚黑
是	係
是…才對	係…至啱
是不是	係咪	係唔係
是不是…？	係咪…先
是不是真的	係咪真嘅
是啊	係呀
是啊！	係吖！	係囉
是嗎？	係咩？	係衙？
是老朋友了	老友鬼鬼
是非多多的	是非多羅羅
時……時……	一時時
時不時	久不久	耐不耐	耐唔耐
時好時壞	一時時
時常	周時	周時無日
時時刻刻	不時	分分鐘
時時如此的	例牌
時興	興
時裝秀	時裝騷
時裝表演	花生騷
時近年底	挨年近晚
時鍾	鐘
時間	時候	檔期	鐘數
時間不夠	時候唔夠
時間到了	夠時候咯	夠鐘
時間很漫長	日子流流長
時間很緊	冇走趲
時間悠長	流流長
時間漫長	流流長
時間表	檔期
時間過長	浸死鴨乸	浸死鴨乸咁耐
時間長	流流長
時髦	型	時嘜	時款	花臣
晃來晃去	吊吊揈	岌岌貢
晃動	岌	岌岌貢	揈	擰動
晃悠	吊吊揈
晃眼	巉	巉眼	棖	棖眼
晃腦袋	揈頭
晃腿	䟴腳
晚	夜	晏	遲
晚一點	遲啲
晚上	夜晚	夜晚黑	晚頭	晚頭夜	晚頭黑	晚黑	黑後
晚上外出	出夜街
晚上業餘加班	炒更
晚安	早唞	早敨
晚會	派對
晚點	過鐘
晨練	晨運
普吉	布吉
普吉島	布吉島
普洱茶	普洱
普通	不過不失	麻麻
普通湯	例湯
普通產品	行貨
普通而已	麻麻啫
普通話	國語
晴天	好天
智慧型手機	智能手機
智障	低能
智障少年	低能兒童
晾涼	攤凍
晾衣服	晾衫	曬衫
晾衣架	晾衫架
暈乎乎	暈舵舵
暈倒	暈低
暈船	暈浪	暈船浪
暈車	暈車浪
暈過去	暈咗
暈頭轉向	暈晒大浪	舂瘟雞
暈飛機	暈機浪
暑假的時間長著呢	暑假流流長
暑假過得很漫長	暑假流流長
暖帽	雪帽
暖暖和和	暖笠笠	暖粒粒
暖暖的	暖暖哋
暖水瓶	暖壺
暖洋洋	暖粒粒
暖烘烘的	暖粒粒
暖瓶	暖壺
暖融融	暖粒粒
暗中串通好	扯貓尾	擝貓尾
暗中行動	出貓招
暗娼	撈女	雞
暗害	陰
暗害別人	陰人
暗自忍受	暗啞抵
暗通消息	通水
暢快	疏肝
暢銷	搶手
暢銷貨	搶手貨
暫且這樣	係噉先	係噉先喇
暫時閒置	畀雪藏
暱稱	朵
暴殄天物	牛噍牡丹
暴牙	哨牙
暴發	發達
暴跳如雷	激到扎扎跳	食咗火藥
暴躁	躁	𤷪	𤷪𤺧
暴露	爆煲	穿煲	踢爆
曖昧	林沈
曖昧親熱	伊挹
曝曬	曬
曠工	偷雞
曠課	偷雞	走堂
曬台	天棚
曬場	禾塘
曬太陽	曬熱頭
曬得夠嗆	曬到死
曬得要命	曬到死
曲別針	萬字夾
曲子	曲
曲頭釘	魚尾釘
更	仲加
更人	老更
更加	仲加
更夫	老更
更糟糕	仲大鑊
更糟糕的是…	好衰唔衰
更衣室	試衫房
書呆子	咪家
書攤	書檔
書桌	寫字枱	書枱
曹操就到	日頭唔好講人，夜晚唔好講鬼
曾孫	塞	塞孫	息
曾有過	試過
曾祖母	太婆	太嫲
曾祖父	太公	太爺
曾經	試過
曾經出現過	試過
曾經有一次	試過有一次
曾經有過	試過
替	戥
替…說好話	為…講好說話
替代	頂檔
替你不忿	戥你唔抵
替你可惜	戥你唔抵
替你抱不平	戥你唔抵
替你碗惜	戥你唔抵
替你難過	戥你難過
替別人的班	頂更
替工	替更
最	至
最倒霉	最弊
最出色的人	一哥
最初	起頭	頭頭
最前面的位置	頭位
最前頭的位置	頭位
最壞	最弊
最多	至多	頂籠
最大的人	一哥
最好	至好
最好夥伴	最佳拍檔
最好搭檔	最佳拍檔
最小	最細
最小的男孩	細仔
最差的	籮底橙
最後	後尾	拉士	收屘	最屘	第屘	褸尾
最後一名	包尾	第屘	老番睇榜第一
最後還是挑了個壞的	左揀右揀，揀個爛燈盞
最有本事的人	一哥
最末	第屘
最末尾	最屘	第屘
最糟	最弊	至弊
最虧	至弊
最討厭	至憎
最近	呢排	呢期	呢輪
最近以來	呢駁
最適合	啱晒	至啱
會	曉	識	識得
會一點	識識哋
會一點兒	會會哋
會一點點就以為自己可以當教師了	識啲啲扮老師
會不會	會唔會
會享受	識歎
會做	識do	識做
會做人	熟性	識做
會動腦	識諗
會吃	識食
會吃會喝	識飲識食
會幹	識do	識做
會往上爬	識撈
會想	識諗
會所三文治	公司三文治	公治
會掙錢	識撈
會法術的人	茅山師傅
會游泳	識游水
會計學	account
會說	識講
會賬	埋單
會過日子	知慳識儉
會鑽營	識撈
會養生	錫身
月亮	月	月光
月初	月頭
月底	月尾
月經	M	大姨媽
有…的	有得…
有一些	有啲
有一天	有一日	有日
有一說一	有碗話碗，有碟話碟
有一點	有些少	有啲	有少少
有一點兒	些少	有些少
有下車的	有慢	有站慢	有落
有主意	有分數
有了喜	有咗
有事做	有嘢做
有事告訴你	有嘢話你知
有事好商量	唔掂諗到掂為止
有事好說	有事慢慢講
有事慢慢說	有嘢慢慢講
有二說二	有碗話碗，有碟話碟
有些	有啲
有人下車	有慢	有站慢	有落
有人请客	有得飲
有什麼三長兩短	有乜冬瓜豆腐
有什麼了不起的	有乜咁巴閉
有什麼可神氣的	得敕喇你
有什麼好處就自己全吞了	汁都撈埋
有什麼用	把鬼	有乜用
有什麼看法	點睇
有什麼稀罕的	有寶咩
有什麼話就說什麼	有乜噏乜
有仇	有過節
有仇怨	有過節
有介蒂	有過節
有何看法	點睇
有何貴幹	有乜事幹
有你瞧的	有得你睇
有便宜可佔	有著數
有便意	屎急	急屎
有信用	有口齒
有個屁用！	把屁咩！
有倚靠	有把炮
有借有還	有拖冇欠
有內容	有嘢到	有料到
有兩下子	有兩度	有兩度散手	有兩手
有兩種可能性	兩睇
有出息	識性
有分量	𠹳
有利	著數
有利於…	益
有利有弊	有辣有唔辣
有前勁沒後勁	有頭威冇尾陣
有力	勁
有勁	勁
有勞	唔該	唔該晒
有口音	唔鹹唔淡
有可能	有之	都似
有名望	有面
有咬勁兒	彈牙	煙韌
有問題	唔係路	有嘢
有啥了不起	有寶咩
有啥用	有乜用	有鬼用
有喜了	有咗
有嚼勁	煙韌
有地位	有面
有地方	有埞
有地方坐	有埞坐
有多困難	容乜易
有好處	有著數
有始有終	好頭好尾	有頭有尾
有始無終	有頭冇尾	有頭威冇尾陣
有孕	有咗	有咗肚	有身紀
有學問	有料
有屁用	把屁
有希望	有得擝
有希望了	有聲氣喇
有後台	腰骨硬
有心事	心翳
有心思	心水清
有情婦	包二奶
有意思	盞	盞鬼	趣怪
有感覺	有feel
有我在	有我喺度
有所收獲	有嘢到	有料到
有才幹	有料
有把握	冇走趲	唔會輸蝕	有把炮	有揸拿	耍家
有排場	架勢
有效	殺食
有數	預咗
有文化	知書識墨
有方法	有板有眼
有時	一時時	間中
有時候	一時時	有啲時	間中
有時間	得閒
有本事	叻	掯	有兩手	有嘢到	有把炮	有料	有料到
有本領	有兩度	有寶
有東西	有嘢
有東西吃	有嘢食
有條有理	有紋有路
有條理	企理	有板有眼	有紋有路
有次序	有板有眼
有步驟	有板有眼
有毅力	捱得
有毛病	神神地
有氣派	威水	架勢
有沒有	有冇
有沒有希望	有冇聲氣
有沒有挽回的可能	有冇得擝
有沒有搞錯	有冇攪錯
有沒有沒有希望	有冇得擝
有法子	有路數
有消息說	有傳
有爹生沒娘教	有爺生無乸教
有牽扯	有挐褦
有牽連	有挐褦
有理	著
有瓜葛	挐挐褦褦	有挐褦
有生氣	風生水起
有男子氣概的	man
有病	唔聚財
有的是	大把
有看頭	有睇頭
有眼力	帶眼
有碼	打格仔
有福氣	托賴
有種	夠薑
有空	得閒
有空兒	得閒
有空閒	得閒
有空間	有埞
有組織罪案及三合會調查科	O記
有線索	有路數
有耐性	好心機
有聲有色	好好睇睇
有能力	使得	有把炮
有能耐	使得	抵手	掯	有料
有膽量	夠膽	夠薑	膽粗	膽粗粗
有臉面	有面
有薪假期	大假
有褒有貶	有讚有彈
有話好商量	有嘢慢慢講
有話說	有嘢講
有話跟…說	有嘢同…講
有話跟他說	有嘢同佢講
有誠信	有腰骨
有說有笑	有傾有講
有貨賣	有得賣
有資格	夠quali	有料
有賣的	有得賣
有贊成也有批評	有讚有彈
有趣	生鬼	盞鬼	貪得意	趣怪	趣致	鬼馬
有路子	有路數
有辦法	使得	有兩度	有把炮	有料	有計
有辦法的	殺食
有迴旋餘地	有得走盞
有途徑	有路數
有這等好事	咁盞
有進展	有嘢到	有料到
有道是	開口有話
有道理	啱聽
有錢	有米	有銀	沓水
有錢人	闊佬
有錢可賺	有銀搵
有錢有地位的女婿	金龜婿
有錢的婦女	闊太
有門路	有路數
有關	有挐褦
有關係	挐挐褦褦
有靠山	有把炮	腰骨硬
有面子	有面
有頭有尾	好頭好尾
有餘	夠有突	有突
有骨氣	夠薑	有腰骨	腰骨硬
有麻煩	濕滯
有黑眼袋	熊貓噉嘅眼
有點	些少	有些少	有啲
有點不對勁	有啲唔妥
有點兒	有些少	有啲	有少少
有點兒古怪	神神化化
有點兒本事	有幾度散手
有點兒酸	酸微微
有點問題	有啲阻滯
有點困難	有啲阻滯
有點發抖	有啲震
有點發燒	有啲燒
有點蠢笨	低低哋
有點阻礙	有啲阻滯
有點麻煩	有啲阻滯
朋克	崩仔
朋友	friend	友	拖友
朋友們	啲朋友
服了你了	保你大
服務員	伙記	侍仔	侍應	侍應生
服務器	伺服器
服服帖帖	聽晒笛
服氣	忿氣	服
服老	忿老
服輸	認低威
朗姆酒	冧酒
望風	䀹水	睇水
朝西	向西
朝鮮薊	雅枝竹
木偶	扯線公仔
木偶戲	公仔戲
木匠	鬥木佬	鬥木師傅
木塊	木嚿
木屐	屐
木屑	木糠
木板	木方
木板拖鞋	屐
木柴	柴
木桌	木枱
木瓜	萬壽果
木紗團	線轆
木耳	雲耳
木訥	一嚿飯噉	木	木獨
木頭	木
木頭木腦	木木獨獨
木頭桌子	木枱
未婚少女	青頭女
未婚男青年	青頭仔
未完成的樓房	爛尾樓
未成年	僆
未閹過的公雞	生豬	生雞
末了	冧屘
末場戲	尾場
末場電影	尾場
末尾	孻	孻屘	屘	後尾	煞尾科	褸尾
末班車	尾班車	尾車
末端	篤
本	今
本事	quali	把炮	散手
本來	計正
本地話	白話
本子	簿
本家	老宗
本屆	今屆
本金	本銀
本錢	本銀
本領	散手	本事
材料	料
杜松子酒	氈酒
束	紮
束胸	紮胸
杯墊	杯薦
杯子	杯
杯柄	杯耳
杯珓	杯
杯的把手	杯耳
東奔西跑	頻頻撲撲
東張西望	眈天望地
東拉西扯	發牙痕
東摸西捏	摸身摸勢
東溜西逛	行東行西
東西	嘢	貨仔
東邊	東便
杵	舂	錐
松果	松雞
松花蛋	皮蛋
松針	松毛
板上釘釘	實牙實齒
板凳	凳
板壁	板障
板子	板
板擦	粉刷	粉擦	粉筆擦
板板六十四	死牛一便頸
板牆	板障
板著臉	口黑面黑	苦瓜乾噉口面	苦瓜噉口面	苦瓜噉嘅面	苦瓜噉面	苦瓜面	黑口黑面
枉費心機	嘥心機	嘥心機捱眼瞓
枕心兒	枕肉
枕芯	枕頭肉
枕頭套	枕頭袋
枕頭芯子	枕頭肉
林子大了什么鳥都有	樹大有枯枝，族大有乞兒
林子大了什麼鳥都有	樹大有枯枝
果凍	啫喱
果肉飽滿	啖啖肉
果醬	占	果占
果醬麵包	果占麵包
架	堂
架勢	駕步
架子大	大嘢	大牌
架子床	碌架床	雙格床
架疊	㨆
柄	椗
柏林牆	柏林圍牆
柏油馬路	蠟青馬路
某些	某啲
某人	乜誰
某某	亞乜人
柑橘	桔
染上	惹咗
染梅毒	生花柳
染病	乃嘢
柔勁	陰力
柔軟	軟熟
柔順	馴品
柔魚	魷魚
柚子	沙田柚	碌柚
查	check
查問	check
查帳	查數
查查	check吓
查核	check
查清楚背景資料	起底
查賬目	查盤數
柱石	柱躉
柳橙	橙
柴火	柴
柵欄	閘
柿子椒	燈籠椒
栗子	風栗
校對	check
校正	較
校正音階	校線
校車	褓姆車
株	樖
核	椗
核兒	核
核對	check
核桃	合桃
根	碌
根本	直情
根治	斷尾
格兒	格仔
格外	零舍
格子	格仔	間格
格子餅	格仔餅
格子鬆餅	格仔餅
栽	安	舂
栽下來	舂落嚟
栽下去	舂落去
栽培	帶挈
栽贓	插贓
桂圓肉	圓肉
桃酥	合桃酥
案件	畸士
案例	畸士
案子	畸士
桌子	枱	檯
桌布	枱布
桌椅板凳	枱枱凳凳
桌球	士碌架	枱波	篤波
桌腿	枱腳
桑巴	森巴
桑巴樂	森巴樂
桑巴舞	森巴舞
桶底	桶篤
梅乾菜	梅菜
梅子	酸梅
梅毒	花柳	花柳病
梗塞	哽
梗阻	嘰趷
條	蔸
條紋	間條
條紋上衣	間條衫
條紋襯衣	間條恤衫
條紋襯衫	間條恤衫
梭哈	曬冷	話事啤
梯子	梯	行梯
梳子	梳
梳辮子	紮辮
棉大衣	棉褸
棉毯	棉氊
棉猴兒	太空褸	雪褸
棉絮	棉胎
棉花套子	棉胎
棉襖	棉衲
棍子	棍
棒	勁	叻	正	盞
棒棒糖	棍仔糖	波板糖
棒球帽	鴨嘴帽
棘手	惡作	戾偈	揦手	撠手	濕滯
棘手的	惡撠
棵	樖	蔸
棵粒小	細粒	細細粒
棺材	四塊半
椅子	凳	凳仔	挨拼椅	椅
椅子的靠背	挨拼
植物的嫩莖	薳
椰子餅	椰子戟
椰末兒	椰蓉
業餘兼職	秘撈
極其	超
極其淺顯	一字咁淺
極力吹噓	力捧
極力節省開支	死慳死抵
極大	爆燈
極好	冇得彈
極害怕	有得震無得瞓
極度	死咁	起勢	鬼死
極度…	鬼死咁…
極度噴怒	火遮眼
極快	快過打針
極愚蠢	蠢到加零一
極懶的人	死蛇爛鱔
極為	極之	超
極為…	鬼咁…
極遠處	冇雷公咁遠
極遲	蚊瞓	蚊都瞓	蛇都死
極長	水蛇春咁長
極高	爆燈
榜樣	人辦
榮辱與共	同撈同煲	同煲同撈
槍	炮
槍斃	打靶	焫
槍決	打靶
槍烏賊	魷魚
樂善好施的人	善長仁翁
樂團	樂隊
樂觀	睇好
樓房	樓	樓宇
樓房倒塌	冧樓
樓房分期供款	供樓
標新立異	出位	搏出位
標簽	label
標緻	弗
標記	記認	識認
標誌	嘜頭
標題	title
模仿	學	學似	有樣學樣
模樣難看	騎呢
模糊	矇
樣	停	味
樣品	辦
樣子	樣	款
樣子很得意	個樣好得戚
樣式	款
樣本	辦
樣板	辦
樣版	人辦
樵夫	斬柴佬
樹墩	樹頭
樹根	樹頭
樹樁	樹頭
樹洞	樹窿
樹蛙	騎呢𧊅
樹袋熊	樹熊
橄欖	山欖	欖	欖角	欖豉	烏欖	生欖	白欖
橄欖核兒	欖核
橘子	桔
橘子汁	橙汁
橘紅色	橙色
橙子	橙
機器人	機械人
機器潤滑油	偈油
機敏	靈水
機會	機	路數	餐屎
機械	梗板
機油	偈油
機警	醒水
機車	綿羊	綿羊仔	電單車
機長	機師	飛機師
機靈	精	醒	醒目	醒神
機靈鬼	醒目仔
機靈點	醒目啲
橡皮圈	橡筋	膠箍
橡皮圖章	圖章
橡皮屑	擦膠碎
橡皮拖鞋	膠拖
橡皮擦	擦字膠	擦紙膠	擦膠	膠擦
橡皮筋	橡筋	膠箍
橡膠	樹膠	膠
橡膠水管	膠喉
橡膠管	膠通
橢圓形	鵝春形	鵝蛋形
橫七豎八的	打橫打掂
橫下一條心	立實心腸
橫著	打橫
橫著寫	打橫寫
橫著拉	趟
橫著放	打橫放
橫著看	打橫睇
橫著睡	打橫瞓
橫行霸道	打橫嚟	牛王	蝦霸
橫行霸道的人	鱷魚頭
橫衝直撞的人	撞死馬
橫豎	君之	橫掂
橫豎都這樣	橫掂係噉
檔	波
檔案	快勞
檢控	抄牌
檢查	check
檢查一下	check吓
檢漏	執漏
檯式機	桌上電腦
檯球	桌球	檯波
檸檬七喜	檸七
檸檬利賓納	檸賓
檸檬可樂	檸樂
檸檬茶	檸茶
檸檬餡兒餅	檸檬撻
櫃台	櫃面
櫃櫥	櫃
櫥櫃	衣櫃
櫻桃	車厘子
欄桿	攔河
權證	窩輪	輪
欠	爭
欠了…的錢	爭…錢
欠人錢	爭人錢
欠他兩塊錢	爭佢兩蚊
欠打	五行欠打	抵打
欠揍	五行欠打	抵打
欠罵	抵鬧
欠起身	趷起身
欠錢	爭錢
次	仗	兒嬉	曳	水	衰	豆泥	輪
次一等的	輸蝕
次品	地底泥	流嘢	籮底橙
次日	第日
次東西	曳嘢
次次	吓吓
次等	流
次貨	曳嘢	籮底橙	衰嘢	豆泥嘢
次透了	真係衰嘅啫
欲罷不能	洗濕個頭
欸	吓	嗱
欺負	恰	拍薑噉拍	蝦	蝦霸
欺負人	蝦人	蝦蝦霸霸	蝦霸
欺騙	呃
款	停
款式	款	花款
款式不同的筷子	鴛鴦筷
款色新穎	有型有款
歇一會兒氣就順了	唞順條氣	唞順氣
歇伏	唞暑
歇口氣	唞啖氣
歇暑假	唞暑
歇氣	唞氣
歌聲	唱口
歌迷	粉絲
歎息	嚡嚡聲
歎氣	嚡嚡聲	透氣
正	正話
正合人的意	合晒心水
正合心意	漯飯應
正合適	啱晒
正在	喺度	喺處	正喺度	正話	緊
正在…	…緊
正在火頭上	火遮眼
正好	正晒	適值
正好…住	…到正
正好到點	啱啱夠鐘
正好被人抓住	捉到正
正如…所說	話事偈	話齋
正如人所願	合晒心水	啱心水
正如俗話所說	俗語有話
正宗的	好正	正牌
正宗的材料	堅料
正室	主人婆
正常	妥
正常物品	正常財
正常的人	好人好姐
正式	官式
正式拍攝	埋位
正式訪問	官式訪問
正式開拍	埋位
正想	想話
正撞上	撞正
正是大年初一	初一流流	年初一流流
正月期間	新年頭	新正頭
正派	忠角
正派人物	忠角
正牌	正斗
正牌貨	正嘢	正斗嘢	正斗貨	正貨
正當…的時候	流流
正直	腰骨硬
正碰上	撞正
正確	著
正聊著	傾吓傾吓
正要	啱啱要	正話
正說著	傾吓傾吓
正談著	傾傾吓
正點	好正
步	層
步步高陞	大話骰
步行機	對講機
武功	功夫
武器	家生	架罉
武術	功夫
歪倒	䠋
歪斜	歪
歪歪斜斜	歪哩歪斜
歪著身子	䠋
歪門邪道	橫丫腸
歲	勾
歷盡艱辛	捱生捱死
死	上咗路	反肚	埋單	拉柴	歎元寶蠟燭	瓜	落下面	釘	釘蓋	香
死不了	死唔去
死不承認	死口唔認
死不瞑目	死唔眼閉	死都唔眼閉
死丫頭	死女包	死妹釘	衰女	衰女包
死了	冧咗	去咗	去咗遊埠	反咗肚	瓜咗	瓜柴	瓜直	瓜老襯	移咗民	走咗	過咗身	釘咗	釘咗蓋	香咗	𢫏國旗	𢫏旗
死了又復活	死咗又翻生
死亡	伸直咗	伸直腳	兩腳一伸	拉柴	玩完	行先一步
死傢伙	死人嘢
死光了	死晒
死去	仙遊	玩完	瓜柴
死去了	仙遊咗	過咗身
死去活來	死過翻生
死命盯著	䀹實	䀹緊	眼䀹䀹
死定了	死梗
死心	心息
死有餘辜	抵死
死東西	死人嘢	死仔包
死板	執滯	梗板
死死地	死咁
死盯著	䀹緊
死結	死纈
死給他看	死畀佢睇
死纏	死跟
死而瞑目	死得眼閉
死背	刨	咪	鋤
死衚衕	倔頭巷	倔頭路
死裡逃生	死過翻生
死路	倔頭巷	倔頭路
死頂著	死撐
死鬼	死人頭	死佬	衰佬
死黨	老死
殘局	蘇州屎
殘忍	冇陰功	陰功
殘渣	渣
殘羹剩飯	冷飯菜汁
殘貨	剩腳	籮底橙
殭屍	喪屍
段	碌
殺人	冧友	收買人命
殺雞	劏雞
毆傷	㩧濕
毆打	抦	𢷮冧
母	乸
母女倆	兩母女
母子	仔乸
母子倆	兩仔乸
母牛	牛乸
母狗	狗乸
母羊	羊乸
母老虎	老虎乸
母親	亞媽	老母
母豬	豬乸
母貓	貓乸
母雞	雞乸
母雞腹內未成形的小蛋	春孳	雞春孳
每人	個個
每件事	樣樣事
每件事情	樣樣事
每個	個個
每個人	個個
每個星期	個個禮拜
每個東西	樣樣嘢
每個禮拜	個個禮拜
每天	日日
每天早上	朝朝	朝朝早
每天晚上	晚晚
每時每刻	不時
每樣東西	樣樣嘢
每次	勻勻	吓吓	次次
每次…	…親	…親就…	…親都…
每次…都…	…親	…親就…	…親都…
每逢	逢親
比	鬥
比不上	低威	唔及得	比唔上	輸蝕
比不上他	唔夠佢嚟
比不上別人	唔及得人
比不過他	唔夠佢嚟
比人差	執輸過人
比人差一等	執輸過人
比價	格價
比剛才還糟糕	仲大鑊
比原來好	仲好
比原來還糟糕	仲弊
比喻下棋時棋子全被對方吃光	劏光豬
比基尼	比堅尼
比基尼泳衣	比堅尼
比得上	及得上
比快	鬥快
比摔跤	鬥𢴈
比本事	鬥叻
比氣力	鬥大力
比漂亮	鬥靚
比目魚	大地魚	左口魚	撻沙魚	鰨沙	鰨沙魚
比美	鬥靚
比能力	鬥叻
比膽子大	鬥大膽
比臂力	拗手瓜
比薩餅	pizza
比賽	鬥
比賽划龍舟	鬥龍船
比賽結束了	完場
比較	比併
比較好	好啲
比闊氣	鬥醒
毛	毫
毛孔	毛管
毛巾	手巾
毛手毛腳	雞手鴨腳
毛毛細雨	雨溦溦
毛毛雨	溦溦雨	雨毛	雨溦	雨溦仔	雨粉
毛毯	毛氈
毛皮	皮草
毛皮大衣	雪褸
毛皮服裝	皮草
毛皮服裝店	皮草店
毛筆字	大字
毛絨	冷
毛絨娃娃	毛公仔
毛絨玩偶	毛公仔
毛絨玩具	毛公仔
毛線	冷
毛線帽	冷帽
毛線手套	冷手襪
毛蟹	大閘蟹
毛衣	冷衫
毛襪	冷襪
毛長外衣	毛巾褸
毫不吝嗇	大破慳囊
毫不相干	冇啲挐褦	冇挐冇褦	冇相干	唔挐耕
毫無收穫	得個吉	食白果
毫無用處	把鬼
毫無辦法	一戙都冇	冇乜符	冇修	冇晒符	冇晒符弗	奈唔何
毫無關係	冇啲挐褦	冇挐冇褦	冇挐褦	唔挐耕
毯子	毛氈	氊
氣	嬲	激
氣不過	唔抵得	抵頸唔住
氣人	激氣
氣勢洶洶	勢兇夾狼	惡死能登
氣勢洶洶的	惡揗揗
氣味	味	𡃴
氣喘	口擘擘
氣喘吁吁	一條氣	口擘擘	嗍晒氣	氣羅氣喘
氣喘如牛	口擘擘
氣墊	氣薦
氣墊船	飛翔船	飛翼船
氣壞	吹爆	吹脹	激奀
氣壞了	一條氣	嬲死	激到好嬲	激到泵泵聲	激到爆	激到甩肺	激奀	激親
氣得吹鬍子瞪眼	嬲到吹鬚睩眼
氣得快要爆炸了	激到爆
氣得渾身發抖	激到扎扎跳
氣得火冒三丈	激到眼火爆
氣得瘦了	激奀
氣得眼睛要冒火的樣子	激到眼火爆
氣得要命	激到死死吓
氣惱	勞氣
氣憤	眼火標
氣槍	風槍
氣死	吹爆	吹脹	激死
氣死了	嬲到死
氣死人	激死人
氣死我	激死我
氣派	威水	醒
氣派大	大牌
氣溫	天口
氣溫高	天口㷫	天口熱
氣炸了	激到爆	激到眼火爆	眼火爆
氣筒	氣泵
氣糊塗了	火遮眼
氣色不好	面口差
氣衝衝	嬲爆爆
氣都喘不過來	透氣都唔順
氣量小	小器
氣鼓鼓的	嬲爆爆
氫化鉀	山埃
氯胺酮	K仔
水上飛行船	飛翼船
水坑	水氹
水壺	水煲
水平一般	未夠班
水平低	冇料	水	水皮	豆泥	鮓	鮓斗	鮓皮
水平低下	低波	未夠班
水平低的人	魚腩
水平高	勁	勁抽
水庫	水塘
水患	水浸
水族館	海洋館	魚缸
水果	生果
水果塔	果撻
水果店	生果舖
水果攤兒	生果檔
水果攤子	生果檔
水果餡餅	果撻
水槽	星盆
水母	白蚱
水泡	水𦢊
水泡兒	水𦢊
水泥	紅毛泥	英泥
水淋淋	水渧渧
水渠	水圳
水火不兼容	水溝油
水災	水浸
水煮	白灼
水煮粽	烚粽
水瓢	水殼
水瓶	水樽
水甕菜	西洋菜
水田芥	西洋菜
水稻	禾
水稻的收成	禾造
水窪	水氹
水管	喉管	水喉	水喉通	通
水缸	缸
水翼船	飛翔船
水蚤	水螆
水蛭	蜞乸
水路走私者	水客
水鍋	水煲
水餃	烚餃
水龍頭	星盆	水喉	水喉掣
求	噅
求人	噅人
求爺爺告奶奶	噅噅篩篩
求職	搵工
求職改行	搵工跳槽
汆	出水	灼	過水	飛水
汗垢	老泥
汗斑	白蝕
汗流浹背	身水身汗
汗禢兒	笠衫
汗臭	汗宿	酸宿
汗衫	笠衫	線衫
汗衫兒	笠衫
汗跡	汗漬
汗餿味	汗宿	酸宿
江湖客	江湖佬
江湖醫生	黃綠醫生
江米	糯米
江米糰子	糯米糍
江邊	海皮
池塘埂	塘基
池獨門兒	撈靜水
污垢	漬
決	奉旨
決不	奉旨唔
決定	諗定
決定好	諗掂
決定成敗	定生死
決心	立心
決絕	斬纜
汽水	荷蘭水
汽油	電油
汽船	電船
汽車	車
汽車鑰匙	車匙
沉住氣	老定
沉悶得要命	悶到死
沉浮興衰	三衰六旺
沉著	他條
沉默寡言	口密	古縮	密實
沏茶	沖茶	焗茶
沐浴乳	沐浴露
沒	冇	未
沒…不行	冇…唔掂
沒…也不行	冇…都唔掂
沒事	冇乜事	冇事	冇嘢
沒事兒	冇事幹
沒事吧？	冇嘢呀嘛
沒事找事	亞茂整餅	亞茂整餅，冇嗰樣整嗰樣	唔衰攞嚟衰
沒人	冇人
沒人光顧	冇人幫襯	唔發市
沒人想要	冇人吼
沒人愛	冇人錫
沒人敢吭聲	冇人敢聲
沒人疼	冇人錫
沒人管	冇王管
沒人管理	冇王管
沒人要	冇人吼
沒人購買	冇人幫襯
沒什麼	乜滯	冇乜	冇乜嘢	冇咩	冇咩嘢	冇嘢	失禮晒	好閒	好閒㗎啫
沒什麼事	冇乜事
沒什麼可怕的	冇有怕
沒什麼壞處	冇壞
沒什麼把握	冇乜把炮	冇乜揸拿
沒什麼特別	冇乜點
沒什麼用	冇乜嘢用
沒什麼說的	唔話得
沒信義	冇腰骨
沒個合適的	冇個啱
沒個準	冇譜
沒做過	冇做过
沒出息	冇出息	冇料	唔生性	爛泥扶唔上壁	餓死老婆瘟臭屋
沒分寸	冇搭霎	耷濕
沒別的原因	無他
沒別的緣故	無他
沒勁	冇癮
沒原則	冇腰骨
沒吃完的	食剩
沒合眼	眼光光
沒命了	凍過水
沒命地幹	做到死死吓
沒商量	冇得講
沒問題	冇事	冇問題	冇研究	得㗎啦
沒問題了	得喇
沒啥好處	冇乜油水
沒地兒放	冇埞放
沒坐穩	坐唔正
沒墊平	攝唔穩
沒多久	冇幾耐
沒多大用處	冇乜嘢用	冇乜用
沒多少	冇乜滯
沒大沒小	冇大冇細
沒好的	茶瓜餸飯，好人有限
沒安穩日子過	冇啖好食
沒完沒了	水蛇春咁長	雞啄唔斷
沒家教	冇家教
沒工夫	冇咁好氣
沒希望	心淡
沒希望了	凍過水
沒弄清楚	擺烏龍
沒影兒的事	煲冇米粥，水汪汪
沒得說	冇得傾	冇得彈
沒心情	冇心機
沒必要	無謂
沒怎麼	冇乜	冇乜滯
沒想到	估唔到	諗唔到
沒想起	冇醒起
沒意思	冇厘癮	冇厘癮頭	冇癮
沒意見	冇研究
沒收私貨	執私
沒教養	冇家教
沒時間	冇時間
沒有	冇	未	未有
沒有…的	冇得…
沒有一個合適的	冇個啱
沒有一句真話	冇句真	講嘢冇句真
沒有一天不	周時無日
沒有一點關係	冇啲挐褦
沒有了	冇晒
沒有人	冇人
沒有人喜歡	冇人吼
沒有人監管	冇王管
沒有什麼	乜滯	冇乜
沒有什麼…的	冇得…
沒有什麼不好	冇壞
沒有什麼事兒	冇乜事
沒有什麼事情	冇乜事
沒有什麼可吃的	冇得食
沒有什麼可談的	冇得傾
沒有什麼壓力的工作	他他條條
沒有什麼好談的了	有乜好傾
沒有什麼牽連	冇挐冇褦
沒有什麼聯繫	冇挐冇褦
沒有位子	冇得坐
沒有依傍	半天吊
沒有依靠	冇把炮
沒有保留	有乜噏乜
沒有信用	冇口齒
沒有停車位	冇埞泊車
沒有公德觀念	冇公德心
沒有其他原因	無他
沒有別的	無他
沒有助手	一腳踢
沒有半點虛假	冇花冇假
沒有回頭的餘地	洗濕個頭
沒有地方停車	冇埞泊車
沒有地方容身	冇埞踎
沒有地方能呆下來	冇埞踎
沒有坐位	冇得坐
沒有坐的	冇得坐
沒有多少	冇乜滯
沒有好日子過	冇啖好食
沒有好結局	爛尾
沒有學問	冇料
沒有完成	未完
沒有希望	冇得擝
沒有希望了	殽晒框	殽框	硬晒舦
沒有意義	無謂
沒有意義的事	無謂嘢
沒有把握	冇把炮
沒有指望	冇得玩	凍過水
沒有機會	冇路數
沒有機會拿出來用	冇埞使
沒有水分	乾鯁鯁
沒有油水可揩	冇啖好食
沒有法子	冇路數
沒有活動的餘地	冇得走趲	冇走趲
沒有牽扯	冇挐褦
沒有牽累	乾手淨腳
沒有理由	唔著
沒有生氣	死死吓
沒有看的	冇得睇
沒有真本事	冇料到
沒有眼光	鬼揞眼
沒有約會	冇街去
沒有結果	吊吊揈
沒有膽量	生人唔生膽
沒有菜吃	捱白飯
沒有著落	吊吊揈
沒有話可說	冇得講
沒有說的	冇得彈
沒有貨賣	冇得賣
沒有資格	唔夠quali
沒有賣的	冇得賣
沒有路子	冇路數
沒有身份	cheap
沒有迴旋的餘地	冇得走趲	冇走趲
沒有道理	無厘頭
沒有那麼便宜的事	邊有咁大隻蛤乸隨街跳
沒有錢用	冇錢使
沒有門路	冇路數
沒有關係	冇挐耕
沒有零票找換	冇散紙續
沒有骨氣的人	軟皮蛇
沒有骨頭	啖啖肉
沒有鬆動的時間	冇得走趲	冇走趲
沒本事	冇嘢到	冇把炮	餓死老婆瘟臭屋
沒氣力的人	軟腳蟹
沒法子	冇乜符	冇晒符	冇符
沒法子相比	冇得比
沒法比	冇得比	冇得頂
沒法轉彎子	硬晒舦
沒注意	唔覺眼
沒注意到	唔覺眼
沒活幹	冇得撈
沒牽連	冇挐褦
沒理由	冇搭霎
沒甚麼希望	凍過水
沒用	冇用	冇鬼用	廢	有鬼用
沒用的	唔等使
沒用的人	廢柴
沒留意	唔覺意	唔覺眼
沒看到	未見到	睇差眼	睇漏眼
沒看見	未見到
沒真本事	冇料
沒睡好	唔夠瞓
沒睡醒	未瞓醒
沒空	唔得閒
沒精打彩	冇厘神氣
沒羞	唔知醜
沒羞沒臊	唔知醜
沒能耐	冇料
沒腦筋	未生埋腦筍	腦筍未生埋
沒膽量	冇膽
沒興趣	冇興趣
沒良心	冇心肝	冇本心	折墮
沒著落	半天吊
沒處躲	冇埞匿
沒見到	未見到
沒見著	未見到
沒見過世面	未見過大蛇屙尿	未見過大蛇屙屎
沒見過大場面	未見過大蛇屙尿
沒記性	冇耳性	冇記性
沒話說	冇嘢講
沒說的	冇得彈	唔話得
沒說過一句真話	講嘢都冇句真	講嘢都冇句真嘅
沒譜兒	冇譜
沒賣的	冇得賣
沒趣	冇癮
沒轍	冇修	冇收	冇晒符
沒轍兒	冇乜符	冇符
沒辦法	乜都假	冇修	冇收	冇晒符	冇法子	冇符	冇計	冇辦法
沒辦法了	冇法啦
沒辦法解釋	解釋唔到
沒那金剛鑽別攬那瓷器活兒	冇咁大個頭唔好戴咁大頂帽
沒那麼多	冇咁多
沒那麼容易	冇咁易
沒錢	冇水	冇銀	手緊	水緊
沒錢可賺	冇得撈
沒錢花	冇錢使	等錢使
沒錢花了	冇晒錢
沒錯	冇錯
沒門兒	冇得傾
沒關係	冇相干	又點話	唔搭界	好閒㗎啫
沒關系	冇關係
沒面子	冇面
沒頂	過頭
沒頭沒腦	無厘頭
沒頭沒腦的	冇厘頭
沒頭腦	低B
沒骨氣	低威	冇腰骨
沙丁魚	沙甸魚
沙啞	沙
沙嗓子	豆沙喉
沙坑	沙池
沙拉	沙律
沙朗牛排	西冷	西冷牛扒
沙發	梳化	梳化椅
沙盒	沙池
沙蟲	禾蟲
沙蟹	曬冷	梭哈	話事啤
沙蠶	禾蟲
沙鍋	沙煲	砂煲
沙鍋滾下山	茶瓜餸飯，好人有限
沙鍋豆腐	豆腐煲
河堤	河壆
河汊	涌
河汊子	河涌	涌
河溝	河涌	涌
河濱	海皮
河蟹	大閘蟹
河豚	雞泡魚
河邊	海皮
沸得溢出	滾瀉
沸水	滾水
沸騰的水	滾水
油乎乎	油淰淰	油湆湆
油嘴滑舌	口甜舌滑
油條	油炸鬼	炸麵
油橄欖	烏欖
油污	油湆湆
油汪汪	油淰淰
油漆	油	漆	漆油
油灰	桐油灰
油炸豆腐	豆泡	豆腐泡
油炸食物	油器
油炸餃子	油角	角仔
油的污跡	油漬
油腔滑調	口甜舌滑	口花花
油膩	耨
油膩膩	油淰淰
油膩黏手	肥湆
油菜苔	拗心白菜	菜心
油角	角仔
治	炮製	睇症
治好	醫好
治病	睇症	醫病
沾上水的	濕水
沾上邊兒了	濕身
沾上麻煩事	濕身
沾便宜	摱車邊
沾光	揩油	摱車邊
沾沾自喜	頭揈揈	鬆毛鬆翼
沿著	順住
泔水	洗米水	潲	米水	豬潲
法國人	法國鬼
法國土司	西多	西多士
法國麵包	法包
法子	橋	路數
法師	南無佬	茅山師傅
法式土司	西多
法式長棍麵包	法包
法律行政人員	師爺
法術	茅山	茅山法術	茅山術
泡	坺	浸	淥	𦢊
泡一個麵吃	淥個麵
泡兒	泡	𦢊
泡吧	落吧	落酒吧
泡妞	溝女	蒲女仔	追女仔
泡沫	泡
泡沫塑料	發泡膠
泡泡糖	吹波糖	吹波膠
泡溫泉	浸溫泉
泡熟	淥熟
泡茶	沖茶
泡軟	浸腍
泡酒吧	蒲吧	蒲酒吧
泡飯	撈飯
泡麵	公仔麵	即食麵	淥麵
波羅包	菠蘿包
波羅包加牛油	菠蘿油
泥土	泥湴
泥坑	泥氹
泥子	桐油灰
泥牛入海	人間蒸發
泥箕	篸
注射器	針筒
注意	吼	吼住	覺意	覺眼	醒定
注意聽好了	聽實
泰坦尼克	鐵達尼號
泰迪熊	啤啤熊
洋上司	鬼頭
洋人	紅鬚綠眼	老番	鬼佬
洋女人	鬼婆
洋娃娃	公仔	毛公仔
洋式樓房	洋樓
洋房	洋樓
洋房子	洋樓
洋文	雞腸
洋李子	布冧
洋梨	啤梨
洋樓	樓
洋橄欖	烏欖
洋洋得意	讕得敕	鬆毛鬆翼
洋洋自得	得戚
洋灰	紅毛泥	英泥
洋白菜	椰菜
洋的	鹹水
洋腔洋調	鬼聲鬼氣
洋芋	薯
洋芋片	薯片
洋芹菜	西芹
洋菜花	西蘭花
洋薊	雅枝竹
洋行里的總經理	大班
洋裙	裙
洋貨	來路嘢	來路貨
洋車	車仔
洋里洋氣	鬼鬼哋
洋銷	鬼銷
洋香菜	洋芫茜	番芫茜
洋鬼子	番鬼佬	老番	鬼佬
洗不掉	㨘唔甩	洗唔甩
洗不清	洗唔甩
洗乾淨	㨘乾淨
洗個痛快澡	沖個靚涼
洗刷衣服的刷子	衫刷
洗手不幹	上岸	收山	收手
洗手台	星盆
洗操	洗白白
洗滌盆	星盆
洗澡	沖涼	洗身
洗澡房	沖涼房
洗澡間	沖涼房
洗照片	曬相
洗相片	曬相
洗米水	米水
洗臉	抹面	洗面
洗臉毛巾	洗面手巾
洗臉盆	面盆
洗菜盆	星盆
洗衣店	洗衣舖
洗衣服	洗衫
洗衣粉	梘粉	洗衫梘
洗錢	洗黑錢
洗頭髮	洗頭
洗髮精	洗頭水
洞	穿窿	窿
洞穿的	通窿
洩氣	漏氣
洩露	爆煲
洩露內幕	爆內幕
洩露出來	爆煲
洩露秘密	爆料
活	生
活動	喐動
活埋	生壅
活屍	喪屍
活死人	喪屍
活活宰殺	生劏
活活的	生勾勾
活海鮮	生猛海鮮
活潑	扎扎跳	生鬼	跳扎扎	跳跳扎
活生生的	生勾勾
活的	生勾勾
活著	在生	生
活著也浪費空氣	唔死都冇用	醫翻嘥藥費
活蝦	生蝦
活見鬼	撞鬼
活該	抵你死	抵死
活蹦亂跳	扎扎跳	跳扎扎	跳跳扎
活蹦亂跳的海鮮	生猛海鮮
活躍	風生水起
洽商	斟
洽談	斟
洽談做買賣	斟盤
派	批
派不上用場	冇埞使
派人	使人
派發	派
派發報紙	派報紙
派送喜餅	派禮餅
派遣人	使人
流下来	流落嚟
流個不停	嗲嗲渧
流出	瀉
流氓	串仔	撈仔	撈家	爛仔	爛佬	躝癱	陀地
流氓女生	串女
流汗	出汗	標汗
流淚	流馬尿
流眼淚	流馬尿
流血	見紅
流行	時款	興
流連	we𠿭𠿭	蒲開	𠿭
流鼻涕	流鼻水
浪費	嘥	嘥撻	大嘥
浪費地方	嘥地方
浪費時間	嘥時間
浪費精力	嘥氣
浪費錢	嘥錢
浪費食物	嘥食物
浮萍	浮薸
浮誇	沙塵	白霍
浮誇輕佻	沙塵白霍
浮起來	蒲起	蒲頭
浴室	沖涼房
浴袍	晨褸
海外城市	外埠
海島	山	洲
海水	鹹水
海水自來水管	鹹水喉
海洛因	海洛英	白粉	粉
海濱	海皮
海濱浴場	泳灘
海產乾貨	海味
海產乾貨店	海味舖
海盜	海賊
海邊	海皮
浸泡	漚
消化不良	濕滯	癪滯	食滯
消受不了	受唔住
消夜	宵夜
消息	料
消息閉塞	背
消毒劑	消毒火酒	火酒
消腫	散瘀
消遣行樂	蒲開
消防栓	街井	街喉
消防水帶	喉轆	消防喉	消防喉轆	滅火喉
消防水管	喉轆	消防喉	消防喉轆	滅火喉
消防水龍	喉轆	消防喉	消防喉轆	滅火喉
消防車	泵車	火燭車
涎	潺
涮	出水	淥	灼	白灼	過水	飛水	𠺘
涮一涮	揸水
涮洗	𠺘
涮鍋子	打邊爐
涮魚片	淥魚片
涼	冷
涼嗖嗖	浸浸涼	涼浸浸
涼快	浸浸涼	涼浸浸	涼爽
涼水	凍水
涼白開	凍水
涼的食物	生冷
涼絲絲	浸浸涼	涼浸浸
涼開水	凍滾水
淅瀝小雨	溦溦雨
淋濕	濕身
淋濕身體	濕身
淘氣	反斗	扭紋	扭計	擒騎	曳	曳曳	百厭	貔貅	跳皮
淘氣包	百厭星
淘氣孩子	貔貅仔
淘氣得要命	曳到死
淘氣鬼	反斗星	扭紋柴	扭計大王	扭計祖宗	死仔	百厭仔
淘汰	foul
淘汰出局	foul出局
淘米	洗米
淘米水	洗米水	米水
淘金	掘金
淚	馬尿
淚包	喊包
淚水	眼水	眼淚水	馬尿
淚汪汪	兩眼濕濕	眼濕濕
淚盈於睫	兩眼濕濕	眼濕濕
淡米爾	泰米爾
淡米爾語	泰米爾語
淡醬油	生抽
淨是說話	齋talk
淫婦	姣婆
淫媒	馬伕
淫穢	鹹濕
淫蕩	姣
深吻	濕吻
深呼吸	透大氣
深夜	夜麻麻
混	撈	蒲
混不下去	冇得撈
混亂之極	七個一皮
混事	撈世界
混凝土	石屎
混合	摳	撈
混合在一起	兩摳	摳埋	摳摳埋埋
混在一塊了	撈亂晒
混小子	衰仔
混帳	打靶佬	打靶鬼
混得好	撈得掂
混得很好	撈到風生水起
混日子	撈	撈世界	胡混	胡胡混混
混水摸魚	搏亂
混淆	撈亂
混淆了	撈亂晒
混混沌沌	懵盛盛
混然無知	懵盛盛
混蛋	契弟	打靶佬	打靶鬼	死佬	衰佬	衰嘢
混進去	混入去
混過日子	行行企企
混飯吃	搵食
淹	沉	浸
淹死	沉死
淹水了	水浸
淺顯易懂	一字咁淺
淺黃色	黃黃哋
添麻煩	騷擾晒
清咖啡	黑啡	齋啡
清早	侵早	晨早
清晨	侵早
清晨時候	大清早流流
清晰	sharp
清涼茶	涼茶
清涼飲料	涼水
清漆	叻架
清潔工人	垃圾佬
清潔整齊	企企理理
清澈	通透
清煮	白灼
清煮蝦	白灼蝦
清賬	清盤
清道夫	垃圾佬
清醒	醒定
清鼻涕	鼻水
減短	減筆
減肥	喼弗
減速	收油
渠務工人	通渠佬
渡口	埗頭
渡江	過海
渣滓	渣
港口	埠
港幣	港紙	鹹龍
港式餐館	茶餐廳
港產電影	港產片
港鈔	港紙
渴	口渴	頸渴
渴望娶老婆	發老婆寒
渴望生兒子	發仔寒
渴望發財	發錢寒
渴望看書	發書寒
游手好閒	迆
游泳	游水
游泳池	游水池
游移不定	心多多
游移不決	心多多
渾渾噩噩	懵盛盛
渾身	周身	成身
渾身不舒服	唔聚財
渾身出虛汗	標冷汗
渾身大汗淋漓	身水身汗
渾身直哆嗦	周身打冷震	成身打冷震
渾身軟綿綿的	週身冇力
渾身酸疼	週身酸痛
湊	共	合
湊上一份	共一份
湊份子	合份送禮	合錢送禮
湊合	不過不失	麻麻哋
湊合用	頂檔
湊在一塊兒	埋堆
湊在一起	埋堆
湊夠	搭夠	湊埋
湊巧	啱	蹺
湊熱鬧	戥興	贈慶	趁熱鬧	趁高興
湊起來	合埋
湊起來有多少？	合埋有幾多？
湊錢	合錢
湊齊	湊埋
湯	湯水
湯匙	匙羹
湯圓	湯丸
源代碼	原始碼
源碼	原始碼
源程序	原始碼
準備	諗住
準備停當	準備定當
準備打架	扎馬
準時	依時依候
準時上班	依時依候上班
準時到	依時依候嚟到
準頭	眼水	眼界
準點	依時依候
溜	走人	鬆人	鼠
溜之大吉	鬆人
溜冰	滑雪	踩雪屐
溜回	鼠翻
溜回來	鼠翻嚟
溜回去	鼠翻去
溜掉	走人
溜旱冰	踩雪屐
溜溝子	托大腳
溜滑梯	𡄽滑梯
溜號兒	走人
溜走	著草	走路	趯更	鬆	鬆人	鼠
溝渠	坑渠
溢出	倒瀉	瀉
溢出來	滿瀉
溢血	爆血管
溫和	馴品
溫度計	寒暑表	探熱針
溫暖	暖
溫暖的	暖粒粒
溫習	溫書
溫習功課	溫功課
溫順	馴品
溺	沉
溺愛	縱	縱壞	錫到燶
溺死	沉死
溺水	沉死
滅了威風	冇晒姣氣
滑	𡄽
滑下	跣落	𡄽
滑下來	𡄽落嚟
滑下去	跣落去
滑了一腳	跣咗一腳
滑倒	跣低	跣親
滑冰	滑雪	滑雪屐
滑動	𡄽
滑旱冰	撈拿	滾軸溜冰
滑梯	𡄽滑梯
滑溜溜	滑捋捋
滑滑梯	𡄽滑梯
滑稽	生鬼	鬼馬
滑腳	跣腳
滑跌	跣	跣低
滑頭	鬼馬
滔滔不絕	雞啄唔斷
滯銷	爛市	耨市
滯銷貨	濕柴	爛市貨
滲井	沙井	沙井口
滲坑	沙井口
滴	渧
滴下	渧
滴下來	渧
滴乾	渧乾
滴個不停	嗲嗲渧
滴答水	水渧渧
滷肉	鹵味
滾	死開	碌	躝	過主
滾一邊去	死開	過主
滾下來	碌落嚟
滾了下來	碌咗落嚟
滾動	碌
滾在地上	碌地	碌地沙
滾壓	轆
滾燙	滾熱辣	焫
滾珠	波子	波珠
滾珠軸承軸承	啤令
滾瓜爛熟	爛熟
滾蛋	死開	趷路	躝屍	躝屍趷路	過主
滾軸溜冰	踩雪屐
滾開	死開	躝	躝開	過主
滾開的水	滾水
滿	頂籠
滿不在乎	唔嗲唔吊
滿員	爆滿	頂籠
滿地打滾	一仆一碌
滿地都是	成地都係
滿天飛的人	冇尾飛陀
滿屋	通屋
滿座	爆滿	頂籠
滿座兒	爆滿
滿座全場	全場爆滿
滿溢	滿瀉
滿臉怒色的人	黑面神
滿臉淚痕	兩眼濕濕	眼濕濕
滿臉羞慚	一面屁
滿臉通紅	面紅紅
滿臉陰雲	口黑面黑	黑口黑面
滿臉鬍子	鬍鬚勒特
滿臉鬍子茬	鬍鬚勒特
滿街	周街	通街	隨街
滿街跑	周街走
滿街都是人	周街係人
滿足	夠算	安樂
滿身	成身
滿身大汗	身水身汗
滿身汗臭味的人	宿包
滿身都是	成身
滿身都濕透了	周身濕晒	成身濕晒
滿頭大汗	成頭大汗
滿頭汗	成頭汗
滿頭霧水	一頭霧水
漁夫	打魚佬
漂亮	好樣	好睇	時嘜	省鏡	索	肆正	靚	靚溜	靚靚
漂亮的女人	靚女
漂亮的小伙子	靚仔
漂亮的男孩	靚仔
漂亮衣服	靚衫	飲衫
漂洋過海	過埠
漂浮起來	蒲起
漂白	漂白水
漂起	蒲頭
漆	油
漆桐油	油桐油
漏洞	差遲	漏罅
漏縫兒	漏罅
漏電	走電
演出	騷
演出期	檔期
演員表	卡士
演員陣容	卡士
演戲	做戲
演戲演到底	做戲做全套
演粵劇	做大戲
演雙簧	扯貓尾	擝貓尾
漢子	佬
漢字	唐字
漫不經心	唔嗲唔吊	水過鴨背
漫天要價	獅子開大口
漫無目的	迆
漫畫	公仔書
漫長	長流流
漱	𠺘
漱口	𠺘口
漱口杯	𠺘口盅
漱口水	𠺘口水
漲紅了臉	面紅紅
漸漸消瘦	陰乾
漿果	啤梨
潑	淋
潑冷水	沖淡水
潑婦	嗌街婆	棖雞婆
潑油漆	淋油
潑糞	淋屎
潑糞便	淋屎
潑辣	棖雞
潑辣貨	棖雞婆
潑野	棖雞
潘趣酒	賓治
潘趣飲料	賓治
潛在水下	昧
潛在水底下	昧落水
潛水	昧水
潛水員	蛙人
潛泳	昧水
潛逃	著草
潤滑油	機油
潦草	烏喱馬扠
潮濕而不通風	罨汁
澀	[湆]	劫	嚡	湆油
澀得難受	揦脷
澆	淋
澆濕了頭	照頭淋
澆花	淋花
澱粉	生粉
澳洲梨	啤梨
激光	鐳射	雷射
激光唱機	鐳射唱機
激光唱片	鐳射唱片
激光錄像片	鐳射影碟
激光電影光盤	鐳射影碟
激怒	激㷫	激嬲	激親
激烈的搏鬥	打大交
濃	𠹳
濃醬油	老抽
濕乎乎	濕坺坺	濕淰淰	濕溚溚	濕趿趿	濕𣲷𣲷
濕淋淋	濕湆湆
濕漉漉	濕淰淰	濕湆湆
濕的	濕水
濕透	濕淰淰
濕透了	濕到淰晒	濕晒
濫用氯胺酮	嗍K
濺	瀄
濾	隔
濾去	隔
瀏覽	擸一眼
瀏覽一遍	睇勻晒
瀝青	蠟青
灌唱片	出碟
灌籃	入樽
灌開水	沖滾水
灑	倒瀉	瀉
灑出	瀉
灘	坺
火兒	撞火	火起
火冒三丈	扯晒火	眼火標	眼火爆
火太旺	火太猛
火性子	炮仗頸
火星	火屎
火星兒	火屎
火星子	火屎
火氣	熱氣
火氣大	熱氣
火災	火燭
火炮	大炮友
火煙味	火𤓓	火𤓓𡃴	𤓓
火燒眉毛	水浸眼眉
火腿三明治	腿治
火舌	火尾
火警	消防警鐘	火燭
火警裝置	消防警鐘
火警警報器	消防警鐘
火車票	火車飛
火車車廂	卡	火車卡
灰塵	塵	泥塵	煙塵
灰心	心息	灰
灰溜溜地	死死氣
灰霾	煙霞
灰鼠蛇	過樹榕
灶神	灶君	灶君老爺
灼	焫
灼傷	焫傷	焫親
炒剩飯	炒冷飯
炒牛肉粉條	炒牛河
炒米粉條	炒河粉
炒糊了	炒燶
炒老闆魷魚	擗炮
炒股票	炒股
炒花生仁兒	南乳肉
炒菜	煮餸
炒菜鍋	鑊
炒買炒賣未建成的樓房	炒樓花
炒賣	炒
炒賣房屋	炒樓
炒賣樓房	炒樓
炒賣股票	炒股	炒股票
炒賣預售屋	炒樓花
炒賣黃金	炒金
炒魷魚	炒	炒魷
炫目	巉	巉眼	棖	棖眼
炫耀	攞彩	曬嘢
炫耀自己	也文也武
炮竹	炮仗
炸	爆
炸蛋球	沙翁
炸開	爆
為	戥
為…著想	為…諗
為了	為咗
為人	份人
為人保媒	揸大葵扇	撥大葵扇
為人好	好人事
為什麼	乜	何解	做乜	做乜事幹	做乜嘢	做咩	因乜事幹	因乜緣故	因乜解究	為乜	為咩	點解
為什麼事	為乜事幹
為什麼事情	為乜事幹
為什麼會這樣	乜噉	乜噉嘅	做乜噉嘅？
為朋友兩肋插刀	捱義氣
為自己打算	諗縮數
為難人	扭計
烏七八糟	林林沈沈	鬼五馬六
烏七八糟的	林沈
烏冬	烏冬麵
烏爾都文	烏都文
烏爾都語	烏都文	烏都語
烏賊	墨魚
烏魚	生魚
烏鱧	生魚
烏龍麵	烏冬	烏冬麵
烏龜	龜
烘乾	㷫乾
烘烤	煨
烙鐵	焫雞
烙餅	薄罉
烤	燒
烤乾	㷫乾
烤出來	焗出嚟
烤土豆	焗薯
烤小豬	燒乳豬
烤熱	㷫熱
烤燒	燒嘢食
烤爐	焗爐
烤番薯	煨番薯
烤箱	焗爐
烤肉	叉燒	叉燒肉
烤肉條	叉燒	叉燒肉
烤肉酥	叉燒酥
烤肉飯	叉燒飯
烤豬	燒豬	金豬
烤豬肉	燒肉
烤雞	燒雞
烤餅	克戟
烤馬鈴薯	焗薯
烤鴨	填鴨	燒鴨
烤鵝	燒鵝
烤鵝腿飯	燒鵝髀飯
烤麵包	多士
烤麵包機	多士爐
热巧克力	熱朱古力
烹調食物的時候加上調料調味	較味
焙粉	泡打粉
無	冇
無中生有	煲水	生安白造
無事可做	空手掉空臂
無事可幹	無聊賴
無人	冇人
無人問津	冇人幫襯
無利可圖	冇乜油水
無利可圖的事	豬頭骨
無力	殘
無可奈何	冇奈何	奈唔何
無可奈何地	死死氣
無可指責	冇得彈
無可挑剔	冇得彈	唔話得
無可挽救	蛇都死
無可救藥	爛泥扶唔上壁
無可比擬	蚊髀共牛髀	蚊髀同牛髀
無可置疑	直情
無可非議	冇得彈
無地自容	一面屁
無妨	冇壞
無容身之地	冇埞踎
無尾熊	樹熊
無影無蹤	人間蒸發
無心	冇心
無情	倔情	絕情
無情義	反骨
無所事事	空手掉空臂	行行企企	迆
無所收獲	冇嘢到	冇料到
無所謂	冇所謂	冇研究	唔嗲唔吊
無時無刻	不時
無本事	水
無格的本子	拍紙簿
無法彌補	殽框
無法挽回	好難摱
無法挽救	殽框
無法算得清楚	計唔清
無法解釋	解釋唔到
無法集中心思	集中唔到
無濟於事的	唔等使
無牽涉	冇挐褦
無理取鬧	發爛渣
無瓜葛	冇挐褦
無產階級	普羅大眾
無用	有鬼用
無用之材	爛泥扶唔上壁
無用的人	跛腳鴨
無病無災	冇穿冇爛
無益的	唔等使
無目標地閒逛	迆
無禮	串
無立足之地	冇埞企
無精打采	冇厘神氣	吽哣	死死吓
無精神	迆
無緣無故	無情白事	無拏拏	無無端端	無端白事	無端端
無聊	冇厘癮	冇厘癮頭	冇癮	無聊賴
無聊死了	悶到死
無能	唔中用	廢
無能力的人	跛腳鴨
無色脣膏	爆坼膏
無處下手	冇埞埋手
無處入手	冇埞埋手
無親無故	冇人冇物
無計可施	老鼠拉龜
無話可說	冇嘢講	冇得傾	冇得講
無論如何	點都好
無論如何也	幾大都
無論如何也不能相信	打死唔信
無論如何也要	幾大都要
無論如何都要	點都要
無論幹什麼事情都不順利	頭頭碰著黑
無賴	光棍	爛仔	爛佬	賴貓君
無路可逃	冇埞走	冇路走
無關	冇挐褦
無關緊要的	唔等使
焦	燶
焦急	喉急	心急
焦臭	臭𤓓
焦躁不安	囉囉攣
然後	然之後
煎蛋捲	奄列
煎雞蛋	奄列
煎雞蛋三明治	蛋治
煙卷	煙仔
煙味	火𤓓	火𤓓𡃴
煙囟	煙通
煙屁股	煙頭
煙民	煙友
煙火	煙花
煙灰缸	煙灰盅
煙燻三文魚	煙三文魚
煙蒂	煙頭
煙鬼	煙鏟
煞	耷逼力
煞尾	埋尾	煞科
煞車	收油	耷逼力	逼力
煤氣管道	煤氣喉
煤油	火水	火油
煤油燈	火水燈
煤油爐	火水爐
照他的樣子做	睇住佢頭
照例	例牌
照做不誤	照殺
照料	湊
照料家務	睇頭睇尾
照料小孩	湊啤啤	湊細蚊仔
照樣	照
照樣兒學	有樣學樣
照樣再來一次	照板煮碗	照板煮糊
照樣受到批評	照彈
照樣可以	都得
照照鏡子	照吓镜
照片	相
照理說	計正
照相	影相
照相機	影相機	相機
照相館	影樓	影相舖
照看一下	幫吓眼
照章辦事	君真
照舊	照
照舊遭指責	照彈
照著樣子做	照板煮碗	照板煮糊
照鏡子	照鏡
照顧	湊
照顧孩子	湊仔
煩	厭
煩悶	翳
煩死了	煩到死
煩躁	躁	𤷪	𤷪𤺧
煮	烚	煲
煮不爛	煮唔腍	煲唔腍
煮去火湯藥	煲涼茶
煮咖啡	煲咖啡
煮夜宵	煮宵夜
煮清涼茶	煲涼茶
煮湯	煲湯
煮焦	煲燶
煮焦了	煲燶咗
煮煳	煲燶
煮煳了	煲燶咗
煮煳了飯	煮燶飯
煮熟	烚熟
煮爛	滾腍	煮腍	煲腍
煮爛了	滾腍晒
煮玉米	烚粟米
煮玉米棒子	烚粟米
煮白薯	烚番薯
煮粥	煲粥
煮粽子	烚粽
煮豬食	漚豬潲	烚豬潲
煮雞蛋	烚蛋	烚雞蛋
煮飯	整飯	煲飯
煮飯吃	煮食
煮飯的鍋	飯煲
煮麵	淥麵
煳	燶
煳味	臭𤓓	𤓓
煽	撥
煽火	撥火
煽爐子	撥爐
熄火	死火
熗鍋	起鑊
熟	淰	黃
熟客	熟客仔
熟悉	熟檔	面善
熟牛肉三明治	牛治
熟米粉卷兒	豬腸粉
熟米粉條	沙河粉	河	河粉
熟練	熟落	熟行
熟過頭了	熟得滯
熨	燙
熨斗	燙斗
熨焦	燙燶
熨衣服	燙衫
熬	捱	漚	烚
熬中草藥	煲藥
熬中藥	煲茶
熬了一輩子	捱一世
熬了個通宵	捱咗成晚
熬夜	戙起床板	捱夜	捱更抵夜	捱眼瞓
熬日子	捱世界
熬煮	漚
熬苦	捱生捱死
熬苦日子	捱世界
熬藥	煲茶	煲藥
熬通宵	捱通宵
熱	㷫
熱乎	㷫起嚟
熱可可	熱朱古力
熱咖啡	熱啡
熱得直冒汗	熱到流晒汗
熱得要命	熱到死	熱到飛起
熱檸檬茶	熱檸茶
熱死了	熱到死
熱水瓶	暖壺	暖水壺
熱淚盈眶	一泡眼淚	兩眼濕濕	眼濕濕
熱烈	七彩
熱烘烘	㷫烚烚
熱熱的	熱熱哋
熱熱鬧鬧	墟墟冚冚
熱的時候	天時熱
熱著吃	監熱食
熱辣辣	㷫烚烚
熱門貨	搶手貨
熱香餅	克戟	班戟
熱鬧	㷫	七彩	旺	鬧熱
熱鬧地區	旺區
熱鬧點	旺區
燈籠花	吊鐘
燉	炆
燉豬蹄	炆豬手	炆豬腳
燉雞蛋羹	蒸水蛋
燒	炆
燒仙草	涼粉
燒傷	燒親
燒水	煲水
燒水壺	水煲
燒烤	燒臘
燒烤店	燒臘舖
燒烤肉食的總稱	燒味
燒焦	煮燶	燶
燒焦了	煮燶咗	燒燶咗
燒焦味	火𤓓	𤓓
燒煳	煮燶
燒煳了	煮燶咗
燒菜	煮餸
燒豬	火腩
燒麥	燒賣
燕子	燕
燕尾夾	魚尾夾
燕麥片	麥皮
燙	㷫	淥	焫
燙傷	㷫親	淥親	焫傷	焫親
燙傷了指頭	淥親手指
燙平衣物	燙衫
燙熟	淥熟
燙著	淥親	焫親
燙衣服	燙衫
燙髮	電髮
燜	炆	焗
燜飯	焗飯
營帳	帳幕	營幕
燥	躁
燥熱	熱氣	躁
燻製食物	煙製食物
燻鮭魚	煙三文魚
爆竹	炮仗
爆米花	炸粟米	爆穀	肥仔米
爆米花糖塊兒	米通
爛	腍
爛帳	爛數
爛攤子	蘇州屎
爛泥	泥湴	湴	爛湴
爛熟	腍
爛爛的	爛蓉蓉
爛玩	爛蒲
爛醉如泥	醉到一劈屎	醉到成坺泥噉
爪牙	馬仔
爬	擒
爬上	擒上
爬上去	擒上去
爬上樹	擒上樹
爬上爬下	擒高擒低
爬台階	行樓梯
爬山	行山
爬樓梯	行樓梯
爬樹	擒樹
爬泳	捷式
爬著鉆	貢
爬行	躝
爬起來	起翻身
爭位子站	爭位企
爭先恐後	推推㧬㧬
爭口氣	爭翻啖氣
爭吵	拗撬
爭執	爭拗
爭著出人頭地	搏出位
爭論	拗	爭拗	鬥駁
爭論得熱鬧非凡	爭到七彩
爭辯	拗	拗頸	爭拗	鬥駁
父子	仔爺
父子倆	仔爺	兩仔爺
父母	爹哋媽咪	老竇老母	老豆老母
父母和子女	親子
父母和子女的關係	親子關係
父親	伯爺	老竇
父親和兒子	仔爺
爸媽	老竇老母
爸爸	亞爸	嗲哋	爹哋	老竇	阿爸
爸爸-2	爸爸	爹哋	老豆	阿爸
爸爸媽媽	嗲哋媽咪	老竇老母
爹	老竇
爹媽	老竇老母
爺爺	亞爺
爽約	放飛機	甩底
牆壁	牆
牆裡開花牆外香	本地薑唔辣
片狀的紅糖	片糖
牌兒	籌
牌子	嘜頭
牌照	拉臣
牌號	嘜	嘜頭
牙垢	牙屎
牙床	牙肉
牙掉了	甩牙
牙縫	牙罅
牙關	牙骹
牙齒	牙
牙齦	牙床	牙肉
牛仔褲	牛記
牛圈	牛欄
牛奶冰淇淋	奶昔
牛奶咖啡	奶啡
牛奶壺	牛奶樽
牛奶瓶	牛奶樽
牛排	牛扒
牛犢子	牛仔
牛皮大王	大炮友
牛皮氣	牛精
牛皮菜	豬乸菜
牛肉卷粉	牛肉腸粉	牛腸
牛肉炒沙河粉	牛肉炒河
牛肉炒河粉	炒牛河
牛肉米粉	牛河
牛肚子上的肥肉	牛腩
牛脾氣	梗頸	死牛一便頸	牛頸
牛腰肉	西冷	西冷牛扒
牛腱子	牛腱
牛腹部的肥肉	牛腩
牛舌頭	牛脷
牛裏脊	牛柳
牛裏脊肉	牛柳
牛裡脊肉	西冷	西冷牛扒
牛蹄	牛腳
牛雜碎	牛雜
牛鞅	牛軛
牛頭不對馬嘴	九唔搭八	牛頭唔搭馬嘴
牡蠣	蠔
牡蠣乾	蠔豉
牢固	實淨
牢房	監倉
牢牢關上	閂到實	閂實
牢獄	倉
牢靠	穩陣
牧牛	睇牛
物以類聚	人夾人緣
牲口	畜牲
牲畜	畜牲
特價	減價	筍價	超筍價
特別	超	零舍
特別注意	䀹
特別設計	度身訂造
特地	特登
特意	專登	特登
特意設計	度身訂造
特殊的記號	識認
特立尼達和多巴哥	千里達及多巴哥
牽	拖
牽手	拖手	拖手仔
牽扯	挐挐褦褦
牽掛	心掛掛	掛住	掛望
牽牛花	喇叭花
牽牽扯扯的	佗手褦腳
牽累	佗累	佗衰
牽累了別人	佗衰人
牽線木偶	扯線公仔
牽腸掛肚	心掛掛
牽連	挐褦
犄角旮旯	窿窿罅罅
犟	硬頸
犧牲預付的訂金	撻定
犬字旁	戾狗邊
犯不著	無謂
犯人	犯
犯傻	霎戇
犯眾怒	犯眾憎
犯糊塗	霎戇
狀況是怎樣的？	乜嘢環境？	咩嘢環境呀？	咩環境呀？	咩環境？
狂妄	牙擦	牙擦擦
狂氣	牙擦	讕得敕
狂熱者	發燒友
狂風暴雨	橫風橫雨
狐朋狗友	豬朋狗友
狗咬狗	狗咬狗骨	鬼打鬼
狗爬式	狗仔式
狗窩	狗竇
狗肉	香肉
狗腿子	馬仔
狗血噴頭	狗血淋頭
狗頭軍師	扭計師爺
狠	狼	狼命	狼死	狼胎
狠宰一筆	斬到一頸血
狠心	狼死
狠揍	㩧濕	拍薑噉拍	摷	砌
狠揍一頓	㩧濕
狠毒	陰毒
狡猾	奸	奸狡	奸貓	奸賴	精	精出骨	蠱惑	陰濕	鬼馬
狡猾古怪	鬼五馬六
独吃	獨食
独吞	獨食
狹窄	窄
狼吞虎咽	食七咁食
狼狽	一仆一碌	咧氣	樣衰	論盡
狼狽不堪	咧晒氣
猛火煮的稀飯	明火白粥
猛然拉動	剒
猜	估
猜不到	估唔到
猜中	估到	估啱
猜到	估到
猜對	估啱
猜拳	拳手	猜包剪𢱕	猜枚
猜著	估到
猜錯	估錯
猥褻	非禮
猥褻侵犯	非禮罪
猴子	馬騮
猶豫	心大心細
猶豫不決	心大心細
獎勵	獎
獎勵你的	醒你嘅
獎賞	打賞
獎金	花紅
獐頭鼠目	蛇頭鼠眼	蛇頭鼠腦
獨家生意	獨市生意
獨斷獨行	自把自為
獨生子	香爐躉
獨眼	單眼
獨眼龍	單眼仔	單眼佬
獨自一人	一支公
獨自幹某事	一腳踢
獨苗	香爐躉
獲獎	攞獎
獻媚	單眼
獻殷勤	讕殷勤
獻香	裝香
獼猴桃	奇偉果	奇異果
玄孫	塞	塞孫
率直	直腸直肚
玉米	包粟	粟米
玉米湯	粟米羹
玉米澱粉	粟粉
玉米片	粟米片
玉米粉	粟米粉	粟粉
玉米花	炸粟米	爆穀	肥仔米
玉米花兒	炸粟米	爆穀	肥仔米
玉米麵	粟米粉
玉鐲	玉鈪
玉鐲子	玉鈪
王八	契弟	水魚	龜公
王八蛋	契弟	麻甩佬	龜蛋
王婆賣瓜	賣花讚花香
玩	蒲
玩兒	反
玩具店	玩具舖
玩命	搏殺
玩弄女孩	溝女
玩撲克	玩啤牌
玩樂	we𠿭𠿭	蒲	蒲開	𠿭
玩樂地點	蒲點
玩樂者	蒲友	蒲精
玩石頭剪子布	猜包剪𢱕
玩花招	出術	出貓招
玩過家家	扮煮飯仔
玩過火了	玩大咗
玩電子遊戲機	打機
玲瓏	骨緻
玲瓏剔透	玲瓏浮突
玻璃球	波子	波珠
玻璃瓶	玻璃樽
玻璃紙	保鮮紙
珍貴	矜貴
班	更
班底	卡士
現世	獻世
現今	呢陣時
現在	今時今日	呢陣	家下	家陣	而家
現在這個年頭	今時今日
現拍現看	即映即有
現暫不討論	唔好話
現眼	獻世
現金	cash	現銀	現錢
現金交易	現銀交易
現金生意	現銀生意
球	波
球場	波地	波場
球拍	波板
球拍子	波板
球票	波飛
球衣	波恤	波衫
球褲	波褲
球評人	講波佬
球賽的票	波飛
球賽評述	講波
球迷	擁躉
球門	龍門
球鞋	波缽	波鞋	運動鞋
理	打理	睬	飛	騷
理會	理	睬	覺眼
理睬	打理	理	睬	騷
理虧	唔著
理解錯誤	擺烏龍
理髮	飛髮
理髮師	飛髮佬
理髮店	飛髮舖	髮型屋	髮廊
琢磨	諗清諗楚
琴酒	氈酒
瑣碎	濕星	濕濕碎	濕濕碎碎	濕碎
瑣碎的東西	濕星嘢
環繞	攬
瓜子臉	瓜子口面	瓜子面
瓜瓜蔓蔓互相牽連	瓜褦藤，藤褦瓜
瓜葛	挐挐褦褦	挐褦
瓜蒂	瓜椗
瓣兒	楷
瓤	肉
瓦斯	煤氣
瓦楞紙	瓦通紙	紙皮
瓦楞紙盒	瓦通紙盒	紙皮盒
瓦楞紙箱	紙皮箱
瓦礫	瓦渣
瓦礫堆	瓦渣崗
瓦罐	罌
瓶	樽
瓶口	樽口
瓶塞	枳	樽塞	樽枳
瓶塞兒	枳	樽枳
瓶子	樽
瓶蓋	樽蓋
瓶裝	樽裝
瓶裝啤酒	樽裝啤酒
瓶裝水	樽裝水
瓶裝飲料	樽裝飲品
瓶身	樽身
瓶頸	樽頸
瓷實	實淨
甘拜下風	認低威
甘於人下	認低威
甘蔗	蔗
甘蔗汁	蔗汁
甘蔗湯	蔗水
甘蔗節	蔗纈
甘薯	番薯
甘藍菜	椰菜	芥蘭
甚至	甚至乎
甜品	糖水
甜湯	糖水
甜甜圈	冬甩
甜甜的	甜甜哋
甜筒	雪糕筒
甜絲絲的	甜椰椰
甜醬烤肉	蜜汁叉燒
甜醬紅燒肉	蜜汁叉燒
甜頭	頭啖湯
甜食	糖水
甜食店	糖水舖
生事	攪事	攪嘢
生兒育女	生仔育女
生動	生鬼
生命危險	條命凍過水
生命難保	條命凍過水
生孩子	生仔	生啤啤	臊	造人
生小孩	生仔	生啤啤	造人
生怕…	驚死…
生怕考不上	驚死考唔到
生意不順利	損手爛腳
生意興隆	旺
生意虧了本	損手
生手	初哥
生日	牛一
生日卡	生日咭
生日聚會	生日會	生日派對
生機勃勃	風生水起
生氣	㷫	勞氣	嬲	扯晒火	扯火	把火	撞火	火滾	發嬲	發老脾
生氣得很	嬲到死
生活安定	安樂茶飯
生活安穩	安樂茶飯
生火	透火
生火做飯	透火煮飯
生爐子	透爐
生牡蠣	生蠔
生物學	bio
生疏	生暴
生疳積	生癪
生病	作病	病咗
生病了	病咗
生痰	惹痰
生的	生勾勾
生皮膚病	生螆
生著吃	監生食
生鏽	生鍟
生魚片	魚生
生龍活虎	生猛	龍精虎猛
產業	物業
產生	惹
用	使
用…下…	食…送…
用不上的	唔等使
用不完	使唔晒
用不用	使唔使
用不著	使乜	無謂
用不著怕	冇有怕
用不著怕了	使乜驚呀
用不著操心	唔使憂
用不著的	唔等使
用不著說	唔使講
用不著那麼生氣	唔使咁火滾
用人家用過的東西	揸二攤
用來	攞嚟	用嚟
用光	使晒
用刀切	搵刀切
用別人用過的東西	執二攤
用力	大力
用力拉	剒
用力敲打	大力敲打
用功	勤力	咪
用小缽蒸的發麵糕	缽仔糕
用強力壓服別人	大石責死蟹
用得著…嗎	使唔使
用心	上心	畀心機
用戶	用家
用手掌承著	托
用手支撐著	托
用手蓋著	揞實
用水洗	搵水洗
用筷子	使筷子
用繩子綁	搵繩綁
用腦力	食腦
用腦袋去想	食腦
用計策	出貓招
用詭計	出術	出貓招
用貪婪的目光盯著	眼甘甘
用長棍打	揇
用鹽醃	搵鹽醃
甩	揈
甩動	揈
甩手不管	闊佬懒理	闊佬懶理
甩手兒	擗炮
甭想	咪指擬	諗都唔好諗
田螺	螺
田雞	蛤乸
田鷄	蛤𧊅
由不得你不信	唔到你唔信
由你決定	是但你揀
由公司開支	開公數
由公家開支	開公數
由於	事關
甲狀腺腫	大頸泡
甲魚	水魚
申報	claim
申斥	徇
男上司	亞sir
男人	佬
男人婆	妹頭	牛王妹
男儐相	兄弟
男妓	鴨
男嬰兒	啤啤仔	臊蝦仔
男子漢大丈夫	男人老狗
男子漢的	man
男孩	仔	男仔
男孩兒	臊蝦仔
男孩子	細路仔
男老師	亞sir
界線	界
留下	留低	留翻	賴低
留分頭	梳西裝
留口供	落口供
留在家裡照顧孩子	留响屋企湊仔
留學	浸鹹水
留心	上心	覺意	醒定
留意	上心	吼	吼住	覺意	顧住
留班	㨆班	重讀
留神	覺意
留級	㨆班	重讀
留著	留翻
留雙辮子	梳孖辮
留點神	睇定啲
畚箕	垃圾篸
畢業文憑	cert
畢業照	畢業相
畢業證	紗紙
畢業證書	cert	沙紙
畢竟	話晒
略微	略略
番茄牛肉通心粉	茄牛通
番茄醬	茄汁
番荔枝	番鬼荔枝
畫圖	畫則
異想天開	妙想天開	開胃
當	照
當…不在	當…冇到
當主力	擔綱
當主角	擔綱
當乞丐	摟席	褸席	踎街
當佣工	打工
當公務員	打政府工	打皇家工
當務之急	三急
當地人	鄉里
當場	當堂
當場出醜	當堂甩鬚
當天的普通湯	是日例湯
當天賣的湯	是日例湯
當女儐相	做姊妹
當妓女	做雞
當媽媽	做媽咪
當季	當造
當家	揸弗	揸莊
當家人	揸弗人
當心	因住	好聲	醒定	醒神	顧住
當心一點	醒定啲	醒少少
當心著涼	因住凍親
當心觸電	因住電親
當時裝模特兒	行天橋
當會計	揸數
當然	實行	梗	梗係
當然…	[嗝]
當然是了	梗係啦
當牛做馬	捱騾仔
當王八	做龜公
當男儐相	做兄弟
當男妓	做鴨
當老師	做先生
當耳邊風	當齋噏
當著	當住
當著他的面說	當住佢講
當著矮子別說短話	崩口人忌崩口碗
當警察	當差
當面	當住
當頭	照頭
當頭一棒	照頭一棍
當頭淋	照頭淋
當頭淋下來	照頭淋
疊	折
疍民	疍家
疏通下水道	通坑渠	通渠
疏通溝渠	通坑渠	通渠
疏通溝渠的師傅	通渠佬	通渠師傅
疑難雜症	奇難雜症
疙瘩	囡	蚊𧕴	𧕴
疣吻沙蠶	禾蟲
疤	𤶸
疤痕	𤶸
疥瘡	癩	癩螆
疥蟲	癩螆	螆
疲倦	殘	癐
疲勞	殘	癐
疳積	癪
疳積病	癪
疹子	赧
疼	痛	痛錫	錫
疼愛	愛錫	痛錫	錫
疼痛	赤
痂	𤶸
病了	病咗
病假單	醫生紙
病假證明	醫生紙
病夫	病君
病得聲音沙啞了	病到聲沙
病貓	生螆貓
痊癒	好翻
痛	親	赤
痛得要命	痛到死	痛到死死吓
痛得要死	痛到死
痛快	心涼
痛打	摷	砌
痛打一頓	摷一輪
痛死了	痛到死
痛罵	數臭	鬧爆
痞子	爛佬
痣	癦
痰	口水痰
痱子	熱痱
痲瘋病	發風
瘀傷	瘀
瘀血	瘀
瘋了	發瘟	發神經	食懵咗
瘋女人	癲婆
瘋子	癲佬	癲婆	發瘟雞	黐線佬
瘋狂採購	掃貨
瘋狂購物	掃貨
瘋狗	癲狗
瘋瘋癲癲	大癲大廢	黐黐哋
瘋瘋癲癲的樣子	喪
瘦了	瘦咗
瘦子	亞奀
瘦小	奀	奀細
瘦小的女孩	奀妹
瘦小的孩子	奀仔
瘦弱	奀瘦	瘦削
瘦弱的小孩	亞奀
瘦得只有一把骨頭	瘦到得棚骨
瘦得要命	瘦到飛起
瘦死的駱駝比馬大	爛船仲有三斤釘	爛船都仲有三斤釘	爛船都有三斤釘
瘦瘦的	瘦到成條柴噉	瘦擘擘	瘦蜢蜢
瘦骨嶙峋的人	瘦骨仙
瘸	跛
瘸子	亞跛	跛腳佬
瘸胳膊	跛手
瘸腳	跛腳
瘸腿	趷	趷腳
瘸鴨	跛腳鴨
療飢	醫肚
癌	cancer
癌症	cancer	癌
癟	凹
癟了	凹咗
癢	痕
癩狗扶不上牆	爛泥扶唔上壁
癩皮狗	生螆狗	軟皮蛇
癩蛤蟆	蠄蟝
癮君子	粉友	道友
癮頭大	爛癮
癱瘓	癱
癲癇	發羊吊
登山	行山
登山服	太空褸
登廣告	賣告白
登船	落船
登記號碼	抄牌
登賬	入數
登高	行山
發	派
發亮	擸擸炩	擸炩	炩擸擸	發光
發出亮光	發光
發動	撻
發動了	撻著
發動引擎	撻車
發動機	摩打
發呆	吽哣	定晒形	發吽哣	發木獨
發售	放盤
發售廣告	放盤廣告
發大火	火遮眼
發展順利	順風順水
發工資	出糧
發怒	㷫	嬲到震	心頭火起	扯晒火	扯火	把火	發㷫	發惡	發老脾
發急	喉急
發怵	發驚青	驚青	驚青青	驚驚青青
發情	發姣
發愁	閉翳
發愣	定晒形	木獨	死估估	發吽哣	發木獨	眼白白
發慌	發驚青	驚青	驚青青	驚驚青青
發抖	打冷震	打震	揗	震
發橫	串
發泡塑料	發泡膠
發泡塑料盒兒	發泡膠盒
發洩怨氣	扽氣
發浪	發姣
發火	勞氣	心頭火起	扯火	把火	撞火	火起	發老脾	發𤷪𤺧
發火兒	發惡
發熱	身㷫
發燒	發㷫	身㷫	身熱
發牌者	荷官	莊荷
發玩兒	爛玩
發球	開波
發生搶劫案	爆夾	爆格
發生水災	水浸
發病	作病
發瘋	發瘟	發癲	發神經	發花癲	發茅	黐線
發瘧子	發冷
發睏	眼瞓
發票	派飛
發粉	泡打粉
發紅包	派利是
發給	派
發羊癇風	發羊吊
發脾氣	心頭火起	爆火	發啷厲	發惡	發晒老脾	發火	發爛渣	發狼戾	發老脾	發𤷪𤺧
發膩	耨
發芽	標芽
發薪水	出糧
發號兒	派籌
發誓	誓願
發財	上岸	發達
發起人	攪手
發軟	腳軟
發達興旺	風生水起
發酒瘋	發酒癲
發酵乳	乳酪
發酵粉	泡打粉
發霉	發毛
發霉的米	糠米
發霉腐爛	霉渧渧
發霉變質	糠
發飆	發爛渣
發麻	痺
發麻風病	發風
白切雞	白斬雞
白吃白喝	黐飲黐食
白吃飯	食塞米
白天	日頭	日頭青青
白嫩	白淨
白幹	枉做	賺攪
白幹一場	白做	賺做
白幹了	白做
白忙活	得個吉	賺攪
白搭	賺嘥氣
白木耳	雪耳
白活了	枉做人
白班	日更
白癡	壽仔	木嘴	茂尼
白白地	枉	賺
白白的	白雪雪
白白耗費	枉費
白白胖胖	肥肥白白
白皙	白淨
白看戲	睇霸王戲
白眼狼	反骨仔
白粉	四號仔	軟仔
白紙本子	拍紙簿
白線軸兒	白線轆
白色有翅母蟻	飛翼
白薯	番薯
白費	枉費	白嘥	賺
白費力氣	乜都假	嘥心機捱眼瞓	賺嘥氣
白費勁	嘥心機捱眼瞓	嘥氣	把鬼	賺嘥氣
白費勁兒	嘥鬼氣
白費口舌	賺嘥氣
白費唇舌	勞氣
白費心思	嘥心機捱眼瞓
白費脣舌	嘥聲壞氣
白麵兒	四號仔	白粉	粉	軟仔
白麵包	方包
百分之	巴仙
百分之一	巴仙
百吃不厭	食過翻尋味
百科	通勝
百貨商店	洋貨舖
百香果	熱情果
的	㗎	㗎喇	嘅
的了	㗎喇
的呀	㗎
的時候	嗰陣時	嘅時	嘅時候
的樣子	嘅樣
的確	認真
的確是	確係
的話	嘅話
皮	曳
皮兒皺	巢皮
皮兒薄	脆皮
皮划艇	輕艇
皮包公司	空殼公司
皮外套	皮褸
皮大衣	皮褸
皮夾克	皮褸
皮帶	褲带
皮搋子	廁所泵
皮條客	馬伕
皮猴兒	雪褸
皮管子	膠喉	膠通
皮箱	皮喼
皮脆	脆皮
皮膚好	皮光肉滑
皮膚嫩滑	皮光肉滑
皮膚皴裂	爆坼
皮膚皺皺的	巢晒皮	巢皮咪𠵼
皮膚開裂	爆坼
皮膚青腫	瘀咗
皮襖	皮袍
皮貨	皮草
皮開骨散	甩頭甩骨
皮革	皮
皴	爆坼
皴裂	爆坼
皸	坼
皺	巢
皺巴巴的	巢咪𠵼	巢𠵼𠵼
皺皺的	巢咪𠵼	巢𠵼𠵼
盆	兜
盆子	兜
盎司	安士
盒子	盒
盒飯	盒仔飯	飯盒
盛	[抔]	裝
盛不下	裝唔落
盛著冰淇淋球的薄餅	雪糕筒
盛飯	[抔]飯	添飯	裝飯
盜版	翻版
盜竊	爆竊
盡	一味	衡晒
盡做	做埋晒
盡全力	唔錫身	搏到盡	搏盡	瞓身搏盡
盡力	落足
盡吹牛	車衡晒
盡心儘力	撲心撲命
盡情表現	也文也武
盡管出招吧	放馬過嚟
盡頭	倔篤	倔頭	篤
監控	睇實
監獄	倉	皇家飯店	監倉
監禁	韞
監視	䀹	䀹住
盤子	碟	薦盤
盥洗盆	星盆
盪鞦韆	打千秋
目不轉睛地看	眼甘甘
目中無人	擺款	頭𩓥𩓥	高高竇竇
目光呆滯	眼光光
目光貪婪的樣子	眼甘甘
目的在於	志在
目瞪口呆	眼都大埋
盯	䀹
盯住	䀹住	䀹實	倔
盯得死死的	䀹實	䀹緊
盯死	䀹住	䀹實
盯死他	䀹住佢
盯著他	䀹住佢	望實佢
盯著看	䀹	望住	望實
盲人的柺杖	盲公竹
盲女	盲婆
盲女孩	盲妹
盲目亂來	舂瘟雞
盲目自大	沙塵白霍
盲腸	橫丫腸
直	掂
直尺	間尺
直性子	直腸直肚
直打哆嗦	揗揗震
直挺挺	直筆甩
直接	直頭
直腸子	直腸直肚
直著	打掂
直著寫	打掂寫
直著放	打掂放
直著睡	打掂瞓
直走	一直去	一直行	直行
直路	掂路
直達火車	直通車
直達車	直通車
相差太遠	蚊髀共牛髀	蚊髀同牛髀
相思樹	臺灣相思
相思豆	紅豆
相思鳥	桂林相思
相框	相架
相機	影相機
相片	相
相片架	相架
相當	相當之
相當困難	OK難
相當好	相當之好
相當特別	相當之特別
相處	相與
相親	相睇	睇老婆
相識一場	一場相識
相隔很遠	離遠
相面	睇相
盼著	心思思
省	慳
省一點吧	慳慳地喇	慳翻啖氣
省了事了	慳翻
省了吧	慳啲啦
省了錢了	慳翻
省事	乾手淨腳
省儉	慳	慳儉
省卻	慳翻
省吃儉用	死慳死抵
省時	慳時間
省時省工	慳水又慳力	慳水慳力
省油	慳油
省錢	慳皮	慳錢
省電	慳電
省電燈泡	慳電膽
省點用	慳啲	慳啲使
省點花	慳啲	慳啲使
眉毛	眼眉	眼眉毛
眉目送情	放生電	放電
看	䁓	望	睇
看一下	睇吓
看一看吧	睇吓咧
看上	睇上眼	睇中	睇啱
看上去	睇嚟	睇落	睇起上嚟
看不上眼	睇唔入眼	睇唔過眼
看不下去	冇眼睇	睇唔入眼	睇唔過眼
看不出	睇唔出
看不出來	睇唔出	睇唔出嚟
看不到	睇唔到	睇差眼	睇漏眼	見唔到
看不慣	睇唔過眼
看不懂	唔識睇	睇唔明
看不清楚	睇唔清	睇唔真
看不見	睇唔見	鬼揞眼
看不起	看低	睇低	睇唔起	睇衰
看不起…	睇…唔起
看不起人	嘴角喵起	高竇
看不起他	睇佢唔起
看不起你	睇你唔起
看不起我	睇我唔起
看不過眼	睇唔入眼	睇唔過眼
看不順眼	唔合眼緣	眼冤	睇唔順眼
看中	睇中	睇啱
看中醫	睇脈
看也不看	望都唔望
看也不看一眼	睇都唔睇
看人臉色	睇人口面
看仔細一點兒	睇真啲
看他多好	睇佢幾好
看你不順眼	睇你唔順眼
看來	睇嚟	睇落
看別人行事	睇頭
看到	睇到	見到
看報紙	睇報紙
看好	睇好
看好他	䀹住佢
看守	吼
看守店舖	看檔	睇檔	睇舖
看守攤子	看檔	睇檔	睇舖
看守著	傍
看家	睇頭睇尾
看小了	看低
看店	看檔	睇檔	睇舖
看形勢	睇水色
看得上	睇起
看得不那麼重要了	睇淡
看得入迷	睇飽眼
看得出	睇得出
看得出來	睇白
看得夠了	睇飽眼
看得懂	睇得明	識睇
看得清	通透
看得起	睇得起	睇起	睇高
看得過去	睇得過
看得開	睇破	睇開
看得順眼	合眼緣
看情況吧	睇過點
看情況行事	睇餸食飯
看情況辦事	睇餸食飯
看戲不買票	睇霸王戲
看扁	睇死	睇衰
看手相	睇手掌
看攤兒	看檔	睇檔	睇舖
看星星	睇星
看時間	睇鐘數
看更	secu	實Q	睇夜	睇更	石Q
看書	睇書
看樣品	睇辦
看樣子	睇個樣	睇樣
看樣本	睇辦
看法	睇法
看淡	睇淡
看清楚	睇清楚	睇真
看清楚一點	醒定定	醒醒定定
看清楚點	擘大眼
看清楚點兒	睇真啲
看準	睇定	睇準	睇真
看準點兒	睇定啲
看漏	眼大睇過籠
看照片	睇相
看牛	睇牛
看球賽	睇波
看病	睇症	睇脈	睇醫生
看相	睇相
看相片	睇相
看看	睇吓
看看再作決定	睇過先
看看再說	睇過先
看看怎麼樣	睇吓點
看真切	睇真
看穿	睇穿
看粵劇	睇大戲
看臉色	睇面色
看舖子	看檔	睇檔	睇舖
看著	吼住	望實	睇住
看著不舒服	篤眼篤鼻	篤鼻
看著他	望實佢
看著生氣	眼冤	眼火爆
看著辦	執生	睇住嚟	睇嚟湊
看著辦吧	睇過點
看見	睇見	見到
看誰堅持得久	鬥撐
看誰快	鬥快
看誰膽子大	鬥大膽
看護	姑娘
看貨樣	睇辦
看貶	嘥
看走了眼	睇差眼	睇漏眼
看走眼	睇差眼	睇漏眼
看起來	睇嚟	睇起上嚟	睇起嚟
看起來不順眼	唔合眼緣
看起來合心意	合眼緣
看起來順眼	合眼緣
看蹭戲	睇霸王戲
看輕	睇衰
看透	睇死	睇淡	睇破	睇穿
看透一切了	睇淡晒
看透了	睇化
看遍	睇勻
看重	睇好	睇起	睇重
看錯	眼大睇過籠	睇錯
看鏡子	照鏡
看開	睇開
看開一點	睇開啲
看電影	睇戲
看電視	睇電視
看頭	睇頭
看頭兒	睇頭
看風水	睇山	睇風水
看（朋友）	探
真	不知幾
真…	夠晒…
真不像樣	真係唔似樣
真不好	好唔掂
真不能相信	打死唔信
真不順當	好唔掂
真丟臉	真係甩鬚
真乖	抵錫
真他媽的麻煩	麻鬼煩
真令人生氣	真揸頸
真便宜	真抵
真倒霉	好衰唔衰	真撞板	真黑	衰晒
真倒霉！	真衰
真受不了	好鬼死難頂
真叫人心煩	煩到死
真叫人惱火	真係火滾
真吃力	真嗍氣
真壞	好衰㗎
真好	真係盞
真實的	冇花冇假
真實資料	堅料
真巧	好蹺	真蹺
真幹	打真軍
真想看書	發書寒
真抱歉	唔好意思
真拿他沒辦法	奈佢唔何	真冇收
真是	正一	正式	認真
真是太麻煩您了	麻煩晒
真是無奇不有	有乜咁出奇
真材實料	堅料
真棒	夠勁
真次	好衰㗎
真正	正一	正式
真正的	正牌
真正的東西	堅料
真氣人	激鬼氣	真揸頸
真沒轍	真冇修	真冇收
真沒轍兒	真冇修
真沒辦法	真冇收
真生氣	真火滾
真的	打真軍	正一	正式	真係
真的不能再真	珍珠都冇咁真
真的嗎？	係咩？	唔係呀嘛
真的很	不知幾
真的很生氣	真系火滾
真的熬不住了	捱唔住
真看不下去	冇眼睇
真空管	真空膽
真糟糕	弊傢伙	最弊	真撞板	衰晒
真絲	絲髮
真謝謝你	多謝晒
真謝謝您關心	你好有心	真有心
真費勁	真嗍氣
真辛苦	真嗍氣
真酷	幾有型
眨	䁪
眨一隻眼	單眼
眨眼	䁪眼	單眼	翕眼
眨眼間	䁪吓眼
眵目糊	眼屎
眼	穿窿
眼中釘	頂心杉
眼光直直地看著	眼定定	眼定定噉望
眼力	眼水	眼界
眼力好	好眼	眼利
眼尖	眼利
眼巴巴	眼光光	眼白白
眼梢	眼尾
眼淚	眼水	眼淚水	馬尿
眼淚汪汪的	兩眼濕濕	眼濕濕
眼珠	眼核
眼珠子	眼核
眼珠滴溜兒亂轉	眼仔碌碌	眼碌碌
眼球鼓起	凸眼
眼皮	眼肚
眼皮子淺	眼淺
眼眵	眼屎
眼眶濕潤	兩眼濕濕	眼濕濕
眼睛	眼
眼睛一大一小	大細眼
眼睛圓圓的	眼仔睩睩
眼睛昏花	眼花花
眼睛滴溜地轉	眼仔碌碌	眼碌碌
眼睛眨巴眨巴的樣子	眼䁪䁪
眼睛睜不開	眼瞠唔開
眼睛睜得大大的	睩大雙眼
眼睛紅紅的	兩眼濕濕	眼濕濕
眼睛蛇	飯鏟頭
眼睛長在頭頂上	頭𩓥𩓥
眼睜睜	眼光光	眼白白
眼睫毛	眼毛	眼翕毛
眼紅	唔抵得	眼熱	眼赤
眼花	眼大睇過籠
眼藥水	眼水
眼袋	眼肚
眼角	眼尾
眼鏡店	眼鏡舖
眼鏡蛇	飯鏟頭
眼高手低	眼闊頭窄
睏倦	眼瞓
睜	睩	瞠
睜一隻眼閉一隻眼	隻眼開隻眼閉
睜不開	瞠唔開
睜不開眼睛	瞠唔開眼
睜大	睩
睜大眼睛	睩眼
睜大雙眼	睩大眼	睩大雙眼
睜眼說瞎話	擘大眼講大話
睜著眼	擘大眼	眼光光
睜著眼睛說謊	擘大眼講大話
睜開	瞠開
睜開眼	瞠開眼
睜開眼睛	瞠開眼
睜開雙眼	擘大眼
睡	瞓
睡一會兒	瞌一陣	瞓陣
睡不了	瞓唔著覺
睡不了覺	冇得瞓
睡不夠	唔夠瞓
睡不安穩	反瞓	惡瞓
睡不著	瞓唔到	瞓唔落	瞓唔著
睡不著覺	冇覺好瞓	瞓唔著覺
睡個舒服覺	瞓個靚覺
睡前	臨瞓	臨瞓前
睡午覺	瞓晏覺
睡地上	瞓地	瞓地下
睡地板	做廳長
睡大覺	大覺瞓
睡得不好	瞓得唔好
睡得不熟	瞓得唔好	瞓得唔淰
睡得好	瞓得好
睡得安穩	瞓得安樂
睡得很沉	好瞓
睡得很熟	好瞓	瞓到淰晒	瞓得好淰
睡得香	好瞓
睡懶覺	覺覺豬
睡椅	懶佬椅
睡熟	淰
睡眠不足	唔夠瞓
睡眼惺忪	眼矇矇
睡著	瞌著	瞓落	瞓著	瞓著覺
睡著了	去咗見周公	搵周公	瞌著咗	瞓著咗	見周公
睡衣	睡衫	瞓衫	薦瞓衫
睡覺	搵周公	瞓	瞓覺	見周公	覺覺豬
睡覺不安寧	反瞓	惡瞓
睡覺不老實	反瞓	惡瞓
睡覺覺	瞓覺覺豬	覺覺豬
睡過頭	瞓過籠
睡醒	瞓醒	瞓醒覺
督察	IP
睪丸	春	春子	波子
睫毛	眼挹毛	眼毛	眼睫毛	眼翕毛
瞄準	睇準
瞇縫著眼睛	眯眉眯眼
瞎	盲	盲眼
瞎了眼	盲眼
瞎吹	放葫蘆
瞎女	盲婆
瞎子	盲佬	盲公
瞎幹	攪攪震
瞎扯	亂車	噏得出就噏	大隻講
瞎扯一通	亂車廿四
瞎搗亂	混吉
瞎搞一氣	舂瘟雞	行路唔帶眼
瞎擺弄	混吉
瞎猜	亂估	估估吓	斷估
瞎眼	盲眼
瞎碰	隔山買牛
瞎編	煲水	生安白造
瞎起鬨	亂㗾
瞎騙	老點
瞎鬧	攪攪震	混吉
瞞不了	瞞唔到
瞞不過	瞞唔到
瞞天要價	獅子開大口
瞞得過	瞞到
瞟	矋
瞟一眼	睄
瞠目結舌	O咀	O晒咀	擘大個口得個窿	擘大口得個窿
瞥	望
瞥一眼	望一眼
瞥他一眼	望佢一眼
瞥看	望
瞧不起	睇唔起	睇衰
瞧他一眼	睄佢一眼
瞪	倔	睩	瞠
瞪大眼睛	睩大雙眼	睩眼	瞠大隻眼
瞪大雙眼	睩大眼	睩大雙眼
瞪眼睛	睩眼
瞪著看	望	望住
瞪著眼	擘大眼
瞪著眼睛	睩大雙眼
瞬間	䁪吓眼
瞭解	收到
瞳人	眼公仔
瞳仁	眼公仔
矛盾	拗撬
知不知道	知唔知
知了	沙蟬
知恥	知醜
知書達禮	知書識禮
知趣	識做	通氣
知道	知	知到
知道了	收到
知道利害	知死
知錯	知衰
短信	短訊
短信息	短訊
短外套	短褸	飛機恤
短斤少兩	呃秤
短斤缺兩	呃秤
短法國麵包	短法包	豬仔包
短葉茳芏	鹹水草	鹹草
矮墩墩的	矮凸凸
矮小	細粒	細細粒
矮小的人	豆丁	豆丁仔
矮胖	矮躉
矯健	扎扎跳	跳扎扎	跳跳扎
石墩	石壆
石屑	石屎
石斑魚	龍躉
石榴	番石榴	結子石榴
石欄	石壆
石沉大海	人間蒸發
石灰水	灰水
石階	石級
石頭	石
石頭剪子布	包剪𢱕	猜呈沉
石頭埂兒	石壆
砂鍋	沙煲	瓦煲	瓦罉
砂鍋飯	煲仔飯
砍	斬
砍人	劈友	斬人
砍傷	斬傷
砍價	僻價
砍樹	斬樹
砍頭	斬頭
破	崩	損	沙	穿
破不開	暢唔開
破了個洞	穿咗窿
破了皮	損咗
破了齋戒	打爛齋缽
破事	衰嘢
破口大罵	破口大鬧
破損	損
破東西	衰嘢
破格	出位
破爛	爛鬼
破爛不堪	甩皮甩骨
破爛的	爛蓉蓉
破爛的衣服	爛衫
破爛貨	爛鬼嘢
破產	執笠
破破爛爛	蓉蓉爛爛
破罐破摔	放䠋
破裂	坼	爆
破財免災	破財擋災
破輪胎	爆肽
破銅爛鐵	爛銅爛鐵
破開	暢
破零票	暢散紙
砸	㨘	㩧	抌	責	𢱕
砸下來	㩧落嚟
砸下去	㩧落去
砸傷	㩧親	責親
砸地基	打樁
砸橄欖核	𢱕欖核
砸瓶	爆樽
砸衣服	車衫
砸鍋	倒竈
砸開	抌開
硅	矽
硅谷	矽谷
硅酸	矽酸
硅酸鹽	矽酸鹽
硅酸鹽水泥	矽酸鹽水泥
硌	哽
硌得慌	哽
硌得難受	哽心哽肺
硌腳	哽腳
硫酸	鏹	鏹水
硬卡紙	咭紙
硬幣	大銀	銀仔
硬撐	死撐	頂硬上
硬撐下去	頂硬上
硬是	夾硬
硬是要他去	夾硬要佢去
硬朗	硬掙	硬淨
硬的	夾硬
硬碰硬	硬打硬
硬著	夾硬
硬著擠進去	夾硬迫入去
硬著頭皮	頂硬上
硬著頭皮幹	頂硬上
硬著頭皮幹下去	頂硬上
硬著頭皮頂著	頂硬上
硬說	死都話
硬邦邦	硬角角
硬頂著	頂硬上
硯台	墨硯
碎渣	渣
碎石	石屎
碎而爛	蓉
碗	兜
碗底	碗篤
碗底子	飯腳
碰	扻	玷	纊	鬥
碰一鼻子灰	食檸檬
碰上	撞啱
碰上倒霉事	撞邪
碰了釘子	揩嘢
碰了頭	扻親個頭
碰傷	扻親
碰傷了	撞親
碰傷了手	整損手
碰到倒霉事	揩嘢
碰壁	撞板
碰巧	撞啱	撞蹺	湊蹺
碰撞	揩
碰杯	飲杯
碰破	扻爛
碰碰運氣	搏吓彩
碰著	扻親
碰見	撞翻	撞見	撞面
碰運氣	搏彩	撞彩
碰釘子	撞板
碰面	撞面
碳酸鈉	梳打
確實	直情	認真
確屬	正一	正式
確確實實	實牙實齒	的而且確
確鑿無疑	的而且確
確鑿的消息	堅料
碼	㨆
碼頭	埗	埗頭	埠	堪
碾	轆
碾傷	轆親
碾壓	轆
磁石	攝石
磁鐵	攝石	攝鐵
磅秤	秤
磕	摼
磕破頭	扻崩頭
磨	揼
磨時間	揼	揼時間
磨蹭	[湆]	姿整	揼	揼時間	湆懦
礙事	掗拃	阻埞	阻頭阻勢
礙手礙腳	外父咁外	撠手撠腳	阻手阻腳	阻頭阻勢
礙手礙腳的	嘰嘰趷趷
礙眼	篤眼篤鼻	篤鼻
礤床	刨
社神	社公
祖先	老祖
祖國	唐山
祖宗有靈	家山有眼
祖母	亞奶	亞嫲	嫲	嫲嫲	阿嫲
祖父	亞爺	爺爺	阿爺
祖父的姐妹	姑婆
祛邪	治邪
神志不清	迷迷懵
神氣	威水	得敕	醒
神經不正常	神神化化
神經失常	黐線
神經有問題	short
神經漢	黐線佬
神經病	short	short哋	發瘟雞	發神經	黐孖筋	黐筋	黐線	黐黐哋
神經網路	神經網絡
神經質	神神地
神聊	打牙骹
神通	把炮
神采奕奕	醒神
神龕	神樓
票	飛
票子	銀紙
票根	飛尾
禁不住	頂唔順
禁不起	頂唔順
禁不起等	唔禁等
禁得住疼	抵得痛
禁止張貼	禁止標貼
禁食甜品	戒甜
禍不單行	死人兼冧屋
禍到臨頭	聽殃	聽衰
禍福	三衰六旺
禦寒	抵冷
禮拜天	禮拜日
禮服	飲衫
禮物	手信
禮金	人情
禽舍	雀屋
禾苗	禾
禿子	光頭佬
禿寶蓋	冧宮頭	冧篷頭
禿寶蓋頭	冧宮頭	冧篷頭
禿頭	撻頭
秀	騷
秀氣	瀟湘
私人住宅小區	私人屋苑
私人偵探	私家偵探
私人小轎車	私家車
私人房屋	私家屋
私人汽車	私家車
私人物品	私家貨
私人的	私家
私人的東西	私家貨
私人秘書	私家秘書
私人診所	私家診所
私人醫生	私家醫生
私人醫院	私家醫院
私塾	㩧㩧齋
私家車	房車
私房錢	私己	私己錢
私生子	野仔
私通消息	通水
秉公處理	揸正嚟做
秉公辦事	揸正嚟做	行得正，企得正
秉公辦理	揸正嚟做
租客	住客
租房又分租給他人	包租
租房間	租房
移動	褪
稀	削
稀奇古怪	古靈精怪
稀巴爛	爛蓉蓉	蓉
稀泥	泥湴	湴	爛湴
稀爛	蓉
稀爛的	爛蓉蓉
稀爛稀爛的	腍啤啤
稀稀爛爛的	削坺坺
稀粥	白粥
稀糊糊	削坺坺
稀而爛	削坺坺
稀軟	削
稀飯	潮州粥	白粥	粥
程序碼	原始碼
程式碼	原始碼
稍不經意	一吓
稍微	些少	略略
稍微帶酸味的	酸酸哋
稍稍	略略
稠	杰	𠹳
稠稠的	𠹳凸凸	𠹳撻撻
稠粥	𠹳粥
稠糊狀	𠹳凸凸	𠹳撻撻
種	停	味
種稻子	種禾
種類	停
稱	磅
稱心	合心水
稱讚	讚
稻子	禾
稻穀	穀
稻苗	禾
稻草	禾稈	禾稈草
積德	積陰功
積怨	仇口
積攢	積積埋埋
積福	積陰功
積蓄	儲	儲埋
積陰德	積陰功
積體電路	集成電路
穩	定當	穩陣
穩住	定啲嚟
穩健	淡定
穩固	實淨
穩妥	定當	穩陣
穩定	定當
穩當	定當	穩陣
穩穩當當	穩穩陣陣
穩重	他條	定當	淡定	穩陣
空	吉
空心的	通心
空心菜	抽筋菜	蕹菜	通心菜	通菜
空房出租	吉屋招租
空房子	吉屋
空手	吉手
空有	賺得	賺得個
空氣調節機	冷氣機
空無一物	空框框
空的	吉
空空如也	空寥寥	空框框
空空的	空寥寥	空框框
空翻	大翻
空落落	空框框
空落落的	空寥寥
空蕩蕩	空框框
空調	冷氣
空調機	冷氣機
空調設備	冷氣機
空身	吉身
空車	吉車
空間	埞
空間大	闊落
空間科學	太空科學
空頭公司	空殼公司
穿	著
穿了個洞	穿咗窿	穿窿
穿了個窟窿	穿咗窿	穿窿
穿了孔	穿咗窿
穿名牌	著名牌
穿大衣	著褸
穿好	著好
穿孔	穿
穿孔的	穿窿	通窿
穿拖鞋	踢拖
穿毛皮服裝	著皮草
穿洞	穿窿
穿洞的	穿窿
穿著	著緊
穿著破爛不堪	爛身爛勢
穿衣打扮	裝身
穿衣服	著衫
穿襪子	著襪
穿錯襪子	著鴛鴦襪
突出	出位
突然	一下	一吓	失驚無神	忽然間	無啦啦	突然間
突然停手	窒手
突然停止	窒住
突然醒來	扎醒
窄巷	冷巷
窄窄的	窄搣搣
窗合頁	窗鉸
窗戶	窗	窗口
窟窿	窿
窨井蓋	沙井蓋
窩	竇
窩囊	廢
窩囊廢	一嚿飯	廢
窩囊氣	焗宿氣
窩夫	格仔餅
窩裡鬥	狗咬狗骨
窩輪	輪
窪	凹
窮得叮噹響	拍手無塵	窮到燶
窮打扮	貪靚
窮折騰	攪攪震
窺視	䁓
竄	標
竄出	標出
竅門	橋	貼士
竊喜	心涼
立	戙
立下決心	的起心肝
立刻	即刻	第一時間
立刻答應	漯飯應
站	企	徛
站不住腳	企唔住腳
站不定	喐喐貢	喐身喐勢
站不穩	䠋	企唔穩
站住	企定	企定定	企定腳
站出來	企出來	企出嚟
站到一旁	企埋一邊	企埋邊
站到一起去	企埋一齊
站台	月台
站在一旁	企埋一邊	企埋邊
站在一起	企埋一齊
站在最高的層面	擸網頂
站好	企定腳
站好馬步	扎馬
站定	企硬
站櫃台	企櫃面	坐櫃面
站穩	企定	企硬
站穩穩的	企定定
站著	戙篤
站起來	企起身	起翻身
站過來	企埋嚟
章魚	八爪魚
童男	青頭仔
童養媳	新婦仔
竪領	企領
竭力	起勢
竭力地	搏晒老命噉	死咁	起勢	起勢噉
竭盡全力	搏到盡	搏晒老命	搏晒老命噉
竭盡全力拼搏	搏盡	瞓身搏盡
端午節	五月節	端午
端正	四正
端端正正	四四正正	四平八正
端莊	肆正
端菜	傳菜
競爭劇烈	爭崩頭
竹子	竹
竹子分枝	竹枝
竹字頭	竹花頭
竹槓	竹升
竹竿	竹	竹升	竹篙
竹節	竹纈
竹篩	疏籬	籬
竹篩子	疏籬	籬
竹簍	笠
竹蓆	竹笪	笪
竹輪	獅子狗
笊籬	罩籬
笑一笑	得啖笑
笑吟吟	笑口吟吟
笑呵呵	笑騎騎
笑哈哈	笑騎騎
笑嘻嘻	笑口吟吟	笑吟吟
笑容滿面	笑口吟吟
笑容燦爛	蓮子蓉口面	見牙唔見眼
笑得合不攏嘴	笑到見牙唔見眼
笑得在地上打滾	笑到碌地
笑得很甜蜜	蓮子蓉口面
笑得滿地打滾	笑到碌地
笑得眼睛都瞇縫了	笑到見牙唔見眼
笑死人	笑大人個口
笑疼了肚子	笑到肚刺
笑眯眯	笑笑口
笑瞇了眼	見牙唔見眼
笑聲	畸畸卡卡
笑著	笑笑口
笑著說	笑笑口話
笑話	gag	笑
笑起來	笑起上嚟
笑靨	酒凹
笤帚	掃把
符合樣品	對辦
笨	一嚿飯噉	戇	木獨	薯	蠢	豬嘜
笨人	大番薯	薯頭
笨手笨腳	一嚿飯噉	論盡	雞手鴨腳
笨手笨腳的人	大番薯
笨拙無能	一嚿飯噉
笨蛋	戇居	水魚	福頭	笨實	粉腸	薯嘜	薯頭	薯頭嘜	蠢人	豬頭嘜
笨頭笨腦	薯頭薯腦
第一	冧巴溫
第一名	一哥
第一把手	一哥
第一次	頭威頭勢
第一班車	頭車
第一筆款	首期
第一號	冧巴溫
第二天晚上	第晚
筆套	筆塔
筆尖兒	筆嘴
筆帽	筆塔
筆畫	畫
筆直	掂筆甩
筆直的	直筆甩
筆記	碌士
筆記本	簿仔	記事簿
等一下	等陣
等一會兒	陣間
等一會兒會說	陣間會講
等一等	等吓
等了很久	等咗好耐
等升降機	等猎
等待時機	吼機會
等得太久了	等到頸都長
等得很久了	等到頸都長
等得脖子都酸了	等到頸都長
等死	聽死
等等	咪住	等埋
等級提升	升呢
等著	聽
等著倒楣	聽殃
等著倒霉	聽衰
等著捱打	聽捱打
等著捱罵	聽鬧
等著死	聽死
等著瞧	睇住嚟
等電梯	等猎
筋斗	大翻	關斗
答應	應承
答茬兒	搭嘴
答非所問	牛頭唔搭馬嘴
箕	篸
算	計
算一下	計吓
算一份	預埋
算一算	計條數
算上	打	打埋
算不清	計唔掂	計唔清
算了	算數	罷就
算了吧	由佢喇	由得佢喇	算數喇	算罷啦
算了啦！	算鬼數
算你狠	怕你呀
算你走運	算你夠運
算命先生	相士
算在一起	合埋
算在裡頭	打埋
算好	計	計掂
算好了	計掂
算帳	埋數	睇數	計數
算我	預埋我
算我一份	預埋我
算清楚	計清楚
算盤珠	算珠
算算	計吓
算算帳	計吓條數
算計	陰
算計人	扭計
算計別人	陰人
算起來	計翻條數	計落	計起上嚟
管	喉	打理	理
管…叫做	嗌…做
管事	揸弗	揸莊
管他	話知佢
管他呢！	關人！
管他的	話知佢
管你那麼多	理你咁多
管區	環頭
管子	喉	通
管工	科文
管理	打理	揸手
管理員	看更
管理錢財	揸數	揸錢
管道	喉
管鉗子	喉鉗
管錢	揸數
箭頭	箭嘴
箭頭符號	箭嘴
箱子	喼	槓
節	堂	碌	纈
節儉	慳儉	慳家
節省	慳	慳儉	慳皮	慳雞
節省位置	慳位	慳地方
節省地方	慳位	慳地方
節約	慳皮
節約點氣吧	慳翻啖氣
節約點用	慳啲
節能燈泡	慳電膽
篩子	疏籬	籬
簡化字	減筆字	簡筆字
簡單	易話為
簡直	直情	直頭
簡直是	簡直係
簡訊	短訊
簡陋	耷濕
簡體字	減筆字	簡筆字
簪子	頭簪
簷下	瓦簷口
簸箕	垃圾篸	篸
籃子	籃
籠子	籠
籠箱	槓
籠罩	幪
籮筐	囖	籮
米湯	飯湯
米粉	粉絲
米粉條	沙河粉	河	河粉
米花糖	米通
米蟲	穀牛
米象	穀牛
米香	米通
籽兒	核
粉刺	暗瘡
粉筆末	粉筆灰
粒兒大	大粒
粒兒小	細粒	細細粒
粒線體	線粒體
粗心大意	論盡
粗心的人	大頭蝦
粗心鬼	大頭蝦
粗暴	躁
粗枝大葉的人	大頭蝦
粗活	粗重嘢
粗略估計	大大話話
粗粗地看了一下	擸一眼
粗粗的	嚡熠熠
粗糙	嚡
粗糙的	嚡熠熠
粗言穢語	爆粗	粗口
粗話	爛口	粗口
粗鹽	生鹽
粘	黐
粘在一塊兒	黐埋一笪
粥品店	粥舖
粵劇	大戲
粵語舊片子	粵語殘片
粽子	粽
精力充沛	生猛
精打細算	知慳識儉
精於計算的人	精仔
精明	精叻	醒目
精明乖巧	精乖伶俐
精明能幹	麻利	麻叻
精明能幹的人	精仔
精液	精
精疲力盡	殘晒
精神	心機	醒神
精神不振作	湆懦懦
精神出了問題	short哋
精神分裂症	思覺失調症
精神奕奕	精神爽利
精神好	爽利
精神恍忽	戇喪
精神為之一振	醒晒神
精神萎靡	死蛇爛鱔噉
精神飽滿	威水	精神爽利
精細	幼細
精緻	的式	骨緻
精靈	精乖	精乖乖
精鹽	熟鹽
糊	撻
糊塗	一頭霧水	大懵	懵	混沌	烏龍
糊塗之極	懵上心口	懵到上心口
糊塗了	食懵咗
糊塗事	烏龍事
糊塗到家了	懵上心口	懵到上心口
糊塗蟲	烏龍王
糊塗鬼	懵仔
糊糊	糊仔
糊糊塗塗	混混沌沌
糊裡糊塗	一嚿雲	懵盛盛	懵閉閉	烏喱單刀	烏龍	胡混	胡胡混混
糊裡糊塗的人	烏鼠
糕餅	戟
糖果	糖
糖水白薯	番薯糖
糖炒栗子	糖炒風栗
糖酒	冧酒
糙了呱唧的	嚡熠熠
糞桶	塔
糟	弊	衰	霉
糟了	堝	弊	弊喇	弊弊冇咁弊	死呀	死啦
糟糕	大鑊	弊	弊傢伙	弊喇	折墮	抵死	死人	死呀	死啦	瓜得	甩質	該煨	論盡	𠹳
糟糕了	衰咗
糟糕透了	衰晒
糟蹋	嘥撻
糟透了	弊弊冇咁弊	死人兼冧屋	真係衰嘅啫	至弊
糧店	米舖
糨	𠹳
糯米糍粑	糯米糍
糯米糰子	糯米糍
糯米麵烙餅	薄罉
糾合	班
糾集	班
糾集同伙	班
約會	拍拖
紅了呱嘰的	紅當蕩
紅利	花紅
紅包	利市	利是	利是錢
紅包封套	利是封
紅包拿來	恭喜發財，利是豆來
紅嘴相思鳥	桂林相思
紅封	封包
紅小豆	紅豆
紅彤彤	紅當蕩
紅得刺眼	紅當蕩
紅燒	炆
紅燒肉	叉燒	叉燒肉
紅燒肉包子	叉燒包
紅燒肉卷粉	叉燒腸粉
紅燒肉粉條	叉燒腸粉
紅燒肉飯	叉燒飯
紅燒醬	叉燒醬
紅目鰱	大眼雞
紅眼鱒	大眼雞
紅紅的	紅當蕩	紅蔔蔔
紅腐乳	南乳
紅葡萄	紅提子
紅薯	番薯
紅蘿蔔	甘筍
紅蘿蔔汁	甘筍汁
紅豆湯	紅豆沙
紅豆粥	紅豆沙
紅通通	紅當蕩
納徵	過大禮
紐卡斯爾	紐卡素
紐澤西	新澤西
純真	純情
紙上公司	空殼公司
紙做的	紙紮
紙幣	銀紙
紙板	瓦通紙	紙皮
紙板箱	紙皮箱
紙煙	煙仔
紙盒	瓦通紙盒	紙皮盒
紙錢	冥鏹	溪錢	金銀紙	陰司紙
紙錢兒	冥鏹
紙錢蠟燭	元寶蠟燭	元寶蠟燭香
紛紛去	湧去
紛紛離去	散水
素什錦	羅漢齋	齋鹵味
素卷狀粉條	羅漢腸	齋腸
素湯	齋湯
素炒沙河粉	炒齋河
素的	走肉	齋
素粉卷兒	羅漢腸	齋腸
素粉條	羅漢腸	齋腸
素菜	齋菜
素質	質素
素食	齋
素食飯館	齋館
素食餐廳	齋館
素麵條	淨面	淨麵
索取保險金	claim保險
索賠	claim
紮辮子	紮辮
累	攰	癐
累了	癐晒
累壞	捱壞
累壞了	癐到死死吓
累得不得了	癐拉拉
累得夠戧	癐到死死吓
累極了	癐拉拉
累死了	做到死死吓	癐到死死吓
累犯	積犯
累癱了	癐拉拉
累積起來	積積埋埋
累贅	論盡
細	幼	幼細
細心	好心機
細想一下	諗落
細毛線	幼冷
細沙	幼沙
細滑	幼滑
細節	detail	橋段
細紋南蛇	過樹榕
細細品嚐	嗒真	嗒真吓	嗒真啲	試真啲
細菌	微菌
細雨紛飛	雨粉粉
紹興黃酒	紹酒
終於	卒之
終於想起來了	諗翻起
終歸	終須
終點站	總站
組樂團	夾band
組樂隊	夾band
絆	撠	纊
絆倒	撠親	纊親
絆腳	撠
絆著	纊親
結	纈
結伙	埋堆
結婚	拉埋天窗	行婚禮
結婚了	結咗婚
結婚照	結婚相
結子	纈
結實	實淨	硬掙	硬淨
結尾	埋尾
結巴	漏口佬	礙口
結帳	埋數	找數	睇數
結拜	契
結束	埋尾	收檔	散檔	煞尾科	煞科
結束放映	落畫
結束買賣	清盤
結果	令到
結業	清盤	進行清盤
結清賬目	找數	清盤	進行清盤
結為乾親	契
結球甘藍	椰菜
結球白菜	娃娃菜	椰菜	肇菜	黃芽白
結球萵苣	西生菜
結算	埋數
結結巴巴	口湆	口窒窒	口震震	吃口吃舌	窒口窒舌
結結巴巴的	嘰嘰趷趷
結賬	埋單	清盤	睇數
絕	盡
絕不	冇話
絕對不行	冇得傾
絕情	狼死
絕招	死橋
絞絲旁	繑絲邊
給	畀	磅
給…了	…親
給…看	畀…睇
給上司責罵	照肺
給人出賣了	畀人賣豬仔
給人慣壞了	畀錫壞咗
給人打劫	爆夾	爆格
給人打輸	畀人拼沉
給人騙了	畀人棍咗
給保護費	派片
給別人欺負	畀人蝦
給定錢	落定
給小費	打賞	畀貼士
給我錢	畀錢我
給水嗆了	畀水濁親
給紅包	畀利是
給臉色他看	畀面色佢睇
給自己一個台階下	跌低揦翻拃沙	跌落地都要揦翻拃沙
給錢	找數	畀銀紙	畀錢	磅水
給面子	畀非士	畀面	賞面
給點面子吧	畀吓面
絨毛娃娃	毛公仔
絨毛玩具	毛公仔
絨螫蟹	大閘蟹
絨衣	波恤
絮叨	口多多	吟	長氣
絮絮不休	雞啄唔斷
統一口供	夾口供
統統	冚唪唥
絲瓜	勝瓜	水瓜
絲綢	絲髮
綁	紮	褦
綁好	紮實
綁架	標參
綁牢	紮實
綁票	標參
綁緊	紮實
綑紮	紮
經一事長一智	多一事長一智
經不起打	唔禁打
經不起考驗	經唔起考驗
經常	不溜	周時	周時無日	好多時	枕住	枕長
經常尿床的小孩	賴尿蝦
經常生病吃藥	孭住藥煲
經得起	禁
經得起打	禁打
經手	過手
經打	禁打
經濟	慳皮
經濟不景氣	市道低迷
經濟不繁榮	市道低迷
經濟學	econ
經濟拮据	乾晒塘	五行欠水	五行缺水
經營酒類生意的執照	酒牌
經理	事頭	老細
經紀	駁腳
經紀人	經紀
綠花椰	西蘭花
綠花菜	西蘭花
綠豆湯	綠豆水
綢緞	絲髮	綢仔
綢緞戲服	絲髮戲服
維夫餅乾	威化餅
維生素	維他命
維護	撐
綰	押
綰起袖子	押高衫袖
網兜	線絡
網咖	網吧
網球	聽尼士
網絡硬盤	網絡硬碟
網路	網絡
網際網路	網際網絡
綳得緊	衡
綽號	朵	花名
緊	衡
緊密合作	拍硬檔
緊密配合	合手	拍硬檔
緊張	肉緊	衡
緊張地	衡晒
緊急出口	太平門
緊接着	嚟緊
緊接著	跟手
緊盯著	睇實
緊緊地	衡晒
緊緊地逼著	逼衡晒
緊緊的	窄搣搣
緊跟	跟到實	跟實
緊跟不捨	跟到實
緊跟對方	跟到實
緊跟著	跟住	跟實
緊身棉襖	棉緊身
緊身襪	襪褲
緊靠著	傍
線圈	線轆
線團	線轆
線軸	線轆
線軸兒	線轆
緝私	執私
編	作	織
編個故事	作個故仔
編出	作出
編出來	作
編席子	織蓆
編籮筐	織籮
編號	冧巴	編碼
編輯	老編
編造	作	安	砌
編造事實	生安白造
緩慢	嚤佗
練拳術	打功夫
練武功	打功夫
練武術	打功夫	食夜粥
練球	練波
練眼力	練眼界
縫	聯	車
縫一個口袋	聯一個袋
縫一套衣服	聯一脫衫
縫上扣子	釘紐
縫兒	卡罅	罅
縫幾針	聯幾針
縫紉	車衫
縫紉機	衣車
縫衣服	聯衫	車	車衫
縫衣機	衣車
縫補	聯
縫補衣服	補衫
縫隙	卡罅	罅
縮作一團	縮埋一嚿
縮寫	減筆
縮成一團	思思縮縮
縮手	窒手
縮短	減筆
總之	總言之
總匯三明治	公司三文治	公治
總括而言	一句講晒
總是	一味	成日
總是遷就	就晒
總比…好	總好過…
總的來說	一句講晒
總的說來	一句講晒
總算	假假哋
總算是	假假哋都係
總經理	波士
總還是	假假哋都係
總開關	總掣
繁華	旺
繃亮	擸擸炩	炩擸擸
繃緊	衡
繞	屈	撠
繞來繞去	兜嚟兜去
繞到後邊去	屈去後便
繞口令	急口令
繞圈子	兜圈
繞彎	兜彎
繞腳	撠	撠腳
繞變壓器	繑火牛
繞路	兜路
繞過去	兜過
繞道	兜路
繞開別人走	兜路行
繩子	索	繩
繩索	索
繫	褦
繫上安全帶	攬belt
繫好安全帶	攬belt
繫鞋帶	綁鞋帶
繫領帶	打𧘹
繭子	枕
繼母	後底乸	後母
繼父	後父
繼續處理	跟進
續水	沖滾水
纏	紮	黐
纏人	黐身
纏小腳	紮脚	紮腳
纏毛線	繑冷
纏綿	煙韌
纏繞	抓	繑
纏腳	紮腳
纏著	黐身
纏足	紮脚	紮腳
纏身	黐身
缺	崩	爭
缺乏实质性	冇嘢到
缺兩個人	爭兩個人
缺口碗	崩口碗
缺席	偷雞
缺德	冇公德心	冇品	冇陰功	折墮	抵死	陰騭
缺德事	衰嘢	陰騭事
缺德的人	抵死友
缺德鬼	抵死友	衰公	陰功鬼	麻甩佬
缺斤短兩	呃秤
缺牙	崩牙
缺課	走堂
缺貨	渴市
缺錢	手緊	水緊
缺錢用	手緊	水緊
缺頭少尾的	甩皮甩骨
缺齒	崩牙
缽	兜
罈子	埕
罐頭	鋁罐
罩	扱	笠
置辦產業	置業
罰單	告票	牛肉乾
罰款通知書	告票	牛肉乾
罰站	企堂
罰點球	十二碼
罵	㨘	嗌	鬧
罵人	鬧人
罵娘	媽媽聲
罵得狗血淋頭	鬧到七彩
罵街	媽媽聲
罵起來	媽媽聲
罷了	之嘛	啫	算數	罷就
罷手	收手
羅哩羅嗦	噒諄
羅嗦	噒諄	好氣	發牙痕	譖	譖氣	譖趙	譖醉
羅庚	羅經
羅漢竹	觀音竹
羅盤	羅經
羅鍋兒	亞駝
羅鍋子	亞駝
羊排	羊扒
羊毛棉毯	羊毛棉氈
美	正斗	靚
美味	好味
美國的	花旗
美女	索女	靚女
美女帥哥	靚仔靚女
美好	盞鬼
美妙	盞鬼
美男子	靚仔
美貌	靚樣
美食評論家	食評家
美麗	靚
羞	羞家	醜
羞人	羞家
羞死了	醜死鬼
羞死人了	醜死鬼
羞羞他	醜吓佢
群	班
義務工作者	義工
義大利	意大利
羶	臊
羶味	臊
羹匙	匙羹
羽絨服	太空褸
羽蝨	雞螆
羽蟲	雞螆
翅膀	翼
翌日	第日
習慣	慣
習慣了	慣咗
習慣了啦	慣咗喇
翠藍	姣婆藍
翹了起來	殽起身嚟
翹曲	殽
翹稜	殽
翹課	走堂
翹起	趷起
翹起大拇指	趷起手指公
翹起尾巴	趷起條尾
翹辮子	拉柴
翻	抄
翻找	抄
翻抽屜	抄櫃桶
翻滾	碌
翻白眼	眼坦坦
翻筋斗	打大翻	打關斗
翻臉	反面	擘面	翻晒面	翻面
翻臉不認人	反面唔認人
翻臉撒野	發狼戾
翻跟斗	打大翻	打關斗
翻跟頭	打大翻	打關斗
耀武揚威	也文也武
耀眼	巉	巉眼	棖	棖眼
老	韌
老K	傾	王
老…	生晒
老一套的	例牌
老丈人	外父
老不正經	老而不
老不死	死老嘢
老主顧	熟客仔
老乞丐	乞兒公
老人院	安老院
老倆口	兩老
老傢伙	老嘢
老催著	催生晒
老兄	哥記	大佬	老友記
老兒子	孻仔
老公	老公仔	蝦子餅
老公呀	老公仔
老到	老積
老剩女	中女
老化子	乞兒
老半天	成日
老友	老死
老土	老餅
老在說	講生晒
老外	番鬼佬	番鬼婆	紅鬚綠眼	老番	鬼佬
老大	一哥	亞一	亞大
老大爺	亞公	伯父	伯爺公
老太太	老太
老太婆	伯爺婆
老姑娘	老姑婆
老婆	老婆仔
老婆婆	亞婆	伯爺婆
老婆餅	冬蓉酥
老家	祖家	鄉下
老實話	好話唔好聽
老實說	老實講句
老小孩	大唔透
老師	亞sir	先生	搣匙	阿Sir
老得皮膚皺皺的	老到巢皮咪𠵼
老惦著	心思思
老想著	心掛掛
老成	老積
老成的少年	老積仔
老手	老行專
老早	一早
老是	一日到黑	成日
老是想著	心思思	心掛掛
老是盼著	心思思
老是順從	就晒
老朋友	死黨	老友	老友記	老友鬼鬼
老朋友一場	一場朋友	一場老友
老本	棺材本
老東西	老嘢
老樣子	都係噉
老氣	老積	老餅
老氣橫秋的	老積
老油子	撈家
老王八蛋	老而不
老病號	病君
老相識	熟口熟面	熟口面	老友記
老糊涂	老懵
老練	老積
老繭	枕
老而不死	老而不
老色鬼	鹹濕伯父
老虎	虎
老處女	老姑婆
老行家	老行專
老談個沒完的	雞啄唔斷
老辣	夠薑
老遠的地方	冇雷公咁遠
老鄉	鄉里	鄉里鬼鬼
老閨女	孻女
老闆	事頭	波士	老細	老頂
老闆娘	主人婆	事頭婆
老頭	伯父
老頭兒	伯爺公
老鴇	馬伕	龜婆
老鷹	崖鷹	麻鷹
老鼠洞	老鼠窿
老齡津貼	生果金
考不上	考唔到
考不及格	考唔合格
考執照	考牌
考慮	諗嘢
考慮一下	諗吓	諗諗吓
考慮考慮	諗吓	諗諗吓
考拉熊	樹熊
考汽車駕駛證	考牌
考行醫資格證	考醫生牌
考駕照	考車牌
考駕證	考車牌
考駕駛執照	考車牌
考駕駛證	考車牌
而且	兼夾	同埋	夾
而且還	仲兼
而已	㗎咋	之嘛	啫
而是	而係
耍人	玩人
耍嘴皮	賣口乖
耍奸	詐奸
耍小孩子脾氣	發細路哥脾氣
耍帥	剒樣
耍弄	玩嘢
耍心眼兒	扭計
耍性子	扭計
耍手段	出貓招	玩嘢
耍把戲	做把戲	玩嘢
耍派頭	擺款
耍流氓	非禮
耍滑	詐奸
耍滑頭	出蠱惑
耍猴子	玩馬騮
耍脾氣	使頸	扭紋
耍花招	出猫招	出術	出貓招	奸貓	奸賴	玩嘢
耍花樣	出蠱惑	玩嘢
耍貧嘴	口花花
耍賴	奸貓	奸賴	矛	矛賴	詐奸	賴貓
耍賴皮	奸貓	奸賴	矛	矛賴
耍騙術	出千	出老千	出貓招
耐	抵	禁
耐人尋味	嗒落有味
耐吃	見食
耐寒	抵冷	禁冷
耐心	好心機
耐熱	禁熱
耐用	實淨	硬淨	禁用
耐看	禁睇
耐磨	禁磨
耐穿	禁著
耐聽	禁聽
耐花	見使
耳垂	耳珠
耳垢	耳屎
耳孔	耳仔窿	耳窿
耳朵	耳	耳仔
耳根軟	耳仔軟
耳機	耳筒
耷拉	耷	耷低
耷拉著腦袋	耷低頭
耷拉著臉	苦口苦面	苦瓜乾噉口面	苦瓜噉口面	苦瓜噉嘅面	苦瓜噉面	苦瓜面
耿介	腰骨硬
聊	傾
聊一會兒	傾陣
聊大天兒	打牙骹
聊天	傾偈	打牙骹
聊天兒	傾世界	傾偈
聊著	傾傾吓
聊電話	傾電話
聖代	新地
聖誕卡	聖誕咭
聖誕節	老番冬	聖誕
聚合	合
聚在一起	埋堆
聚會	派對
聚會地點	蒲點
聚腳點	蒲點
聚首	聚腳
聚首的地方	聚腳地
聯繫	褦
聰慧	精乖	精乖乖
聰慧精伶	精乖伶俐
聰明	叻	精	精乖	精乖乖	醒	醒目	醒神	靈水
聰明不到哪裡去	唔叻得去邊
聰明人	叻仔	醒目仔
聰明伶俐	精乖伶俐	話頭醒尾	醒	靈醒
聰明伶利	醒目
聰明反被聰明誤	叻過籠
聰明的女人	叻女
聰明能幹	精叻
聲勢大	大陣仗
聲勢巨大	墟墟冚冚
聲音	聲
聲音很小	好細聲	細細聲
聲音沙啞	喉嚨拆晒	喉沙	聲沙
職業	pro
職稱	title
聽不懂	唔識聽	聽唔明
聽不見	聽唔到
聽不進去	冇耳聽	水過鴨背	聽唔入耳
聽候	聽
聽到傳言	收風
聽到匯報	收風
聽到消息	收到風
聽到風聲	收到風
聽天由命	各安天命
聽好啦	聽住嚟
聽得懂	聽得明	識聽
聽得懂不會說	識聽唔識講
聽得見	聽得到
聽指揮	聽笛
聽歌曲	聽歌
聽著舒服	啱聽
聽著順耳	啱聽
聽話	精乖	精乖乖	聽教	聽笛
聽說	承聞	聽聞	聽聞話	聽聞講	聽講	聽講話
聽課	聽書
聽錯	聽過隔籬
聽錯了	聽過隔籬
聽音樂	聽歌
肆意侵犯他人	蝦得就蝦
肉丁	肉粒
肉包	叉燒包
肉包子	大包	雞球大包
肉排	扒	肉扒
肉舖	肉檔
肉麻	核突	肉酸	骨痺
肉麻得要命	痺到死
肉麻死了	痺到死
肋骨	𩩍骨
肖邦	蕭邦
肘	踭
肚子	泡	肚
肚子不對勁	肚腍
肚子不舒服	個肚有啲唔妥	肚腍
肚子很餓	好肚餓
肚子疼	肚赤
肚子痛	肚痛	肚赤
肚子餓	肚餓
肚皮	肚腩
肚臍	肚臍窿
肛門	噼噼窿	屎眼	屎窟窿
肝	膶
肝臟	肝	膶
股	朕	𩗴
股票公開發行的公司	上市公司
股票資料	股經
肥皂	梘	番梘	番鹼	鹼
肥皂泡	番梘泡
肥皂泡兒	番梘泡
肥皂液	梘液
肥皂片	梘片
肥皂盒	梘盒
肥皂粉	梘粉
肥碩	肥屍大隻
肥胖	肥屍大隻
肥褲腿	闊褲腳
肥頭大耳	肥屍大隻
肩	膊
肩膀	膊頭
肯吃虧	抵得諗	抵諗
肯定	一實	實	實係	實牙實齒	實行	直情
肯定…	[嗝]
肯定不是	實唔係
肯定是	硬係
肯定糟糕	實弊
肯定行	實得
肺臟	肺
肺都氣炸了	激到甩肺
胃口	喉腩
胃口不好	唔開胃	滯口
胃口不好的感覺	翳滯
胃口大	大食
胃口太大	大食
胃口好	開胃
背	佗	孭	背脊	鋤
背书包	孭書包
背光	背手影
背包	背囊
背叛	反骨
背口袋	孭袋
背在身上	孭上身
背地裡傷人	督背脊	金手指
背嬰兒	孭臊蝦仔
背孩子	孭仔
背小孩	孭仔
背帶	孭帶
背幼兒	孭仔
背後使壞	煮米	煮重米
背後議論	唱
背後議論他人	唱衰
背泳	背式
背著	佗住
背著孩子	佗住細路
背負	孭
背起	孭起
背運	當黑
背過臉去	厲埋片面
背部	背	背脊
背黑鍋	孭鑊
胖	肥
胖乎乎	肥嘟嘟	肥揗揗
胖了	肥咗
胖女人	肥婆
胖女子	肥婆
胖姑娘	肥妹
胖婦人	肥婆
胖子	肥佬
胖小子	肥仔嘜
胖瘦	肥瘦
胖胖的	肥嘟嘟	肥揗揗
胖起來了	肥咗
胡亂幹	亂咁嚟
胡來	亂嚟
胡吹	亂車	老點
胡思亂想	亂咁諗	亂咁諗嘢	亂諗嘢
胡攪蠻纏的人	吊靴鬼
胡椒粉	古月粉
胡混	攪攪震	蒲
胡編	砌
胡編亂造	生安白造
胡蘿蔔	甘筍	紅蘿蔔
胡蘿蔔汁	甘筍汁
胡言	齋噏
胡言亂語	發噏風
胡說	亂噏	亂車	唱	噏	滾紅滾綠	齋噏
胡說些什麼	噏啲乜呀
胡說八道	亂噏廿四	亂講嘢	滾紅滾綠	發噏風	鬼上身
胡說！	你講嘢呀？
胡謅	噏	生安白造
胡鬧	扭紋	攪嘢	星君	柴娃娃	滾紅滾綠	胡混
胳肢	擳
胳肢窩	胳肋底
胳膊	手瓜	手臂	手骨
胳膊上的腱子	老鼠仔
胳膊窩	胳肋底
胳膊粗壯	手瓜起腱
胳膊肘	手踭
胳膊肘兒往外不往裡	手指拗出唔拗入
胳膊肘朝外拐	手指拗出	手指拗出唔拗入
胳膊腕兒	手骹
胳膊腕子	手骹
胳臂	手骨
胸	心口
胸中有數	心知肚明
胸中發悶	心翳
胸口	心口
胸口疼	心口痛
胸悶	心翳
胸有成竹	好定當	定當	有分數
胸泳	蛙式
胸章	襟章
胸罩	胸圍
胸脯	心口
胸膛	心口
胸針	心口針
能力	料
能受委屈	抵得諗	抵諗
能吃	大食	食得
能吃就吃	食得就食
能吃能幹	食得做得
能吃能睡	食得瞓得
能吃苦	捱得	捱得苦
能夠	識
能夠忍受	抵得
能屈能伸	搓圓撳扁
能幹	使得	做到嘢	做得	叻	抵手	醒目
能忍讓	抵得諗	抵諗
能打	打得
能治好	醫得翻
能熬	捱得
能省就省	慳得就慳	慳得過就慳
能睡	瞓得
能節約多少算多少	慳得幾多算幾多
能聊	好傾
能言善辯	牙尖嘴利	識講嘢
能跑多快呀？	走得幾快吖
能辦好	攪得掂
脅持	騎劫
脆	彈牙	爽口	爽脆
脆弱	化學
脆皮烤肉	脆皮叉燒
脆皮紅燒肉	脆皮叉燒
脆脆的	脆卜卜
脊梁	背脊
脖子	頸
脫	除
脫下來	除落嚟
脫下手錶	除手錶
脫不了身	甩身唔到
脫不開身	行唔開
脫位	甩骹
脫光了衣服	除晒衫
脫光衣服	剝光衫褲	剝光豬
脫口而出	口快快
脫手	執死雞	甩手
脫穎而出	出位
脫臼	甩骹
脫落	甩
脫衣服	剝衫	除衫
脫衣褲	除衫褲
脫褲子	除褲
脫襪子	除襪
脫襯衫	除恤衫
脫貨	斷市
脫身	甩身
脫銷	斷市
脫鞋子	除鞋
脫髮	甩頭髮
脱下	除低
脾氣	火氣	老脾
脾氣不好	唔好老脾	火頸
脾氣不怎麼好	火氣唔係幾好
脾氣倔強	板頸
脾氣壞	醜頸
脾氣好	好相與	好頸	腍善
脾氣差	唔好老脾
脾氣很好的人	腍佛
脾氣拗	死牛一便頸
脾氣暴躁	火頸	狼戾
脾氣犟	死牛一便頸
腋下	胳肋底
腋毛	胳肋底毛
腋窩	胳肋底
腎臟	腎
腐朽	廢
腘窩	腳坳
腥羶	臊
腦袋	頭殼
腦袋瓜	頭殼
腦袋發漲	頭大
腮幫子	腮
腰	腰骨
腰帶	褲頭帶
腰桿子	腰骨
腰桿子硬	腰骨硬
腰椎骨	腰骨
腰痛	腰骨痛
腰部	腰骨
腱子	腱
腱子肉	腱
腳上的繭子	腳枕
腳上的老繭	腳枕
腳制動器	腳掣	腳踏掣
腳嚴重扭傷	拗柴
腳小趾	腳趾屘
腳崴了	拗柴
腳底	腳板底
腳底板	腳線
腳後跟	腳踭
腳心	腳板堂
腳手架	棚	棚架
腳抽筋了	拗柴
腳拇趾	腳趾公
腳掌	腳板堂	腳板底
腳朝上	打倒掟
腳板	腳線
腳氣	香港腳
腳煞	腳掣	腳踏掣
腳癬	香港腳
腳發麻	腳痺
腳背	腳面
腳趾甲	腳甲
腳趾縫	脚趾罅
腳趾頭	腳趾
腳跟	腳踭
腳踏車	單車
腳踏車車閘	單車掣
腳踏車道	單車徑
腳踝	腳眼
腳部麻痺	腳痺
腳都站軟	企到腳軟
腳鐲	腳鈪
腳顫動不已	䟴身䟴勢
腳麻了	腳痺
腸胃不適	濕滯
腹瀉	屙	屙啡啡	屙肚	肚屙
腹部	肚腩
腹部的肥肉	腩
腿	腳	髀
腿一蹬	伸直咗	伸直腳	兩腳一伸
腿力	腳骨力
腿桿子	腳骨
腿毛	腳毛
腿發軟	軟腳蟹
腿肚子	腳瓜	腳瓜瓤	腳瓜眈	腳肚	腳肚瓤
腿軟	腳軟
膀大腰圓	大隻騾騾
膝蓋	膝頭	膝頭哥	膝頭蓋
膝蓋骨	膝頭蓋	菠蘿蓋
膝部的後面	腳坳
膠卷	菲林
膠帶	膠紙
膠管	膠喉
膠管子	膠喉	膠通
膠鞋	水鞋
膩	[湆]	厭	耨	耨喉
膩了	厭
膩人	耨喉
膩口	湆口
膩味	厭
膩煩	厭
膩蟲	菜螆
膽大	夠膽	膽粗	膽粗粗
膽大包天	沙膽	膽生毛
膽大妄為	膽生毛
膽子大	夠膽	膽粗	膽粗粗
膽子小	細膽
膽小	冇膽	細膽
膽小怕事	生人唔生膽
膽怯	發驚青	驚青	驚青青	驚驚青青
膽戰心驚	揗揗震
膽敢	夠膽
膽量	膽色
臀	躉
臀部	躉
臆想	估估吓
臉	口面	面	面口
臉上發紅	面紅紅
臉兒	口面
臉孔	面口
臉有菜色	面青	面青青
臉皮	面皮
臉皮厚	面皮厚
臉盆	面盆
臉紅	面紅
臉紅紅的	塊面紅紅哋
臉色	口面	面色
臉色不好	面色唔好
臉色很差	面口差	面色咁差
臉色發白	面青	面青青
臉色發紅	面紅紅
臉色發青	面青	面青青
臉色蒼白	面青	面青青
臉色陰沉	苦瓜乾噉口面	苦瓜噉口面	苦瓜噉嘅面	苦瓜噉面	苦瓜面
臉色難看	口黑面黑
臉蛋	面珠	面珠墩	面豬登
臉蛋兒	面珠	面珠墩
臉面	面
臉頰	面珠墩	面豬登
臊味	宿哼哼	餲
臊臊的	餲堪堪
臊臭	餲
臘肉	燒臘
臘腸	風腸
臘製食品	臘味
臥具	被鋪
臥室	睡房
臥房	睡房
臨時抱佛腳	臨急抱佛腳
臨時演員	臨記	茄喱啡
臨睡前	臨瞓	臨瞓前
臨陣退縮	縮沙
自不待言	唔在講
自以為	讕
自以為內行	認屎認屁
自以為很了不起	讕惡爺	讕有寶
自以為很內行	讕在行
自以為很利害	讕惡爺
自以為是	叻唔切	自把自為	認屎認屁	識少少扮代表	讕有寶
自以為有本事	讕有嘢
自作主張	自把自為
自作聰明	叻唔切	識少少扮代表	讕醒
自來水	水喉水
自來水定時供應	制水
自來水管	水喉	通
自來水開關	水喉掣
自刎	割頸	鋸頸
自助餐	蒲飛
自動扶梯	電梯
自動換檔	自動波
自動變速器	自動波
自動變速裝置	自動波
自取毀滅	周身蟻
自命不凡的樣子	咁串
自嘆不如	認低威
自大	沙塵	牙擦	牙擦擦	高竇
自大的人	高竇貓
自己人	自己友
自己人打自己人	狗咬狗骨	鬼打鬼
自己作賤	扻頭埋牆
自己動手	親力親為
自己洩露	自爆
自己當老闆可說話	打自己工，自己話事
自恃內行	讕在行
自恃有本事	讕有嘢
自懲	扻頭埋牆
自找倒霉	自己攞嚟衰	賺衰
自找苦吃	揦屎上身	攞苦嚟辛
自找辛苦	搵嚟辛苦
自找麻煩	周身蟻	唔衰攞嚟衰	揦屎上身	搵嚟攪嘅	攞嚟攪嘅	攞嚟衰	攞嚟賤	攞苦嚟辛	自己攞嚟衰
自排變速箱	自動波
自排車	自動波
自暴自棄	放䠋
自然	實行
自然而然	自不然
自甘下賤	攞嚟賤
自由式	捷式
自由泳	捷式	自由式
自相殘殺	狗咬狗骨
自私	精	精出骨
自行公開	自爆
自行其是	自把自為
自行曝光	自爆
自行車	單車
自行車小徑	單車徑
自行車店	單車舖
自行車路	單車徑
自行車車閘	單車掣
自行車道	單車徑
自行車鈴鐺	唥鐘
自行車鑰匙	單車鎖匙
自視甚高	高高竇竇
自討苦吃	周身蟻	唔衰攞嚟衰	扻頭埋牆	搵嚟攪嘅	攞嚟攪嘅	攞嚟衰	攞嚟賤	攞苦嚟辛	自己攞嚟衰
自誇	曬嘢
自誇命運好	曬命
自誇有福氣	曬命
自認不如	認低威
自謙	認衰仔
自負	牙擦	牙擦擦
自賣自誇	賣花讚花香
自高自大	沙塵白霍	詐型	讕醒
自鳴得意	讕得敕	讕盞
臭丫頭	衰女	衰女包
臭吹	牙擦	牙擦擦	讕盞
臭小子	僆仔	契弟	死僆仔	衰仔
臭氣熏天	冤崩爛臭
臭烘烘	臭亨亨	臭烹烹
臭罵	徇	數臭	鬧爆
臭罵一頓	徇一餐
臭美	讕叻	讕盞	飽死
臭臭的	臭亨亨	臭烹烹
臭蛋	堝蛋
臭蟲	木蝨
臭鐵鏽味兒	臭鍟𡃴
至少	大大話話
至於	講到話
臼齒	大牙
舀	[抔]
舀子	殼
舀水	[抔]水
舀湯	[抔]湯
舀飯	[抔]飯
舅奶奶	妗婆
舅媽	妗母
舅母	妗母
舅爺	舅公
舅舅	舅父
與	共	同	夾	挐
與…無關	唔關…事	唔關事
與其…不如…	仲冇咁嬲
與我無關	唔關我事
與眾不同	騎呢
興奮	high	㷫	爽利
興師動眾	大陣仗
興建	起
興旺	旺	風生水起
興隆	風生水起
興風作浪	攪風攪雨
舉一反三	話頭醒尾
舉動不靈	論盡
舉止輕浮	摸身摸勢
舉行婚禮	行婚禮
舉行聚會	開P	開派對
舊式樓房	唐樓
舊式的車	老爺車
舊房子	唐樓
舊時	舊底
舊的	陳皮
舊的東西	陳皮嘢
舊的粵語片	粵語殘片
舊貨	二攤	二攤貨	夜冷	夜冷貨
舊車	老爺車
舌吻	濕吻
舌尖	脷尖
舌苔	脷苔
舌頭	脷
舒坦	梳芙
舒暢	安樂	梳芙
舒服	他他條條	他條	安樂	梳芙	爽	爽手	疏肝	自在
舒服自在地看報紙	歎報紙
舒氏豬齒魚	青衣	青衣魚
舒適	安樂
舒適自在地享受	䟴䟴腳
舔	舐	𦧺
舔嘴脣	舐嘴	𦧺嘴脣
舔手指	𦧺手指
舖子	商舖	舖	舖頭
舞會	派對
舞獅子	舞獅	醒獅
航天飛機	太空梭	穿梭機
舵	舦
船票	船飛
船襪	龍船襪
船靠岸	埋頭
良心	本心
色	鹹濕
色子	色	色仔
色彩斑駁	花哩碌
色彩繽紛	七彩
色情場所	架步	黃色架步
色情按摩	邪骨
色情書	鹹書
色情片	三仔	四仔	鹹濕片	鹹濕電影	鹹片
色情狂	生雞精
色情的	鹹
色拉	沙律
色澤	色水
色狼	鹹濕佬	鹹蟲
色鬼	生雞精	鹹濕佬	鹹濕鬼	麻甩佬
艾滋病	愛滋病
芝蔴油	蔴油
芝麻油	麻油
芝麻球	煎堆
芡粉	生粉
芥末	芥辣
芥末醬	芥醬
芥藍菜	芥蘭
芫荽	芫茜
芭蕉	大蕉
芯	肉
花	使
花不完	使唔晒
花俏	花弗
花光	使晒
花匠	花王
花卉市場	花墟	花市
花崗岩	麻石
花崗石	麻石
花市	花街
花店	花檔	花舖
花招	卓頭	貓招
花招兒	卓頭
花斑斑	花哩胡碌	花哩花碌
花朵	花
花格裙子	格仔裙
花格襯衫	格仔恤
花椰菜	椰菜花
花樣	花款	花臣
花氣力的家務	粗重嘢
花瓶	花樽
花生仁兒糖塊兒	花生糖
花生油	生油
花生米	花生肉
花色	款	花款
花花公子	花心蘿蔔
花花綠綠	花哩碌
花莖甘藍	芥蘭
花蕾	冧	花冧
花言巧語	口花花
花費	使
花邊	厘士
花里胡哨	花哩碌	花哩胡碌	花哩花碌
花錢	使錢
花錢無度	荷包亂揈
花錢無計劃	洗腳唔抹腳
花骨朵	花冧
芹菜	西芹
苗條	瀟湘
苛刻	醃尖
苛待	治
苛求	醃尖
苦不堪言	苦過弟弟
苦力	咕哩	豬仔
苦工	豬仔	驢仔
苦摳苦攢	死慳死抵
苦瓜	涼瓜	菩薘
苦著臉	揦口揦面	揦埋口面	苦瓜乾噉口面	苦瓜噉口面	苦瓜噉嘅面	苦瓜噉面	苦瓜面
英俊瀟灑	靚仔有型
英文文學	lit
英里	咪
茄子	矮瓜	茄	茄瓜
茅坑	屎坑
茅坑兒	屎坑
茅屋	屋仔
茅舍	屋仔
茉莉花茶	香片
茗茶	歎茶
茬	造
茭白	茭筍
茭白筍	茭筍
茶壺把	茶壺耳
茶樓酒肆	食肆
草地	草披
草字頭	草花頭
草字頭兒	草花頭
草莓	士多啤梨
草莓奶昔	士多啤梨奶昔
草莓牛奶冰淇淋	士多啤梨奶昔
草藥	山草藥
草藥店	山草藥舖
草頭兒	草花頭
荒謬	茂
荔枝旺季	荔枝造
荔枝核兒	荔枝核
荸薺	馬蹄
荸薺粉	馬蹄粉
莊家	荷官	莊荷
莊稼人	耕田佬
莓	啤梨
莙薘菜	豬乸菜
莫名其妙	一頭霧水	無厘頭
莫名其妙的	冇厘頭
莫洛尼	莫羅尼
莫西干頭	崩裝
莫非	唔通
莽撞	擒青
莽撞的人	撞死馬
菜	餸	餸菜
菜單	菜牌	餐牌
菜市場	街市
菜市小販	街市仔	街市佬
菜心兒	菜膽
菜心兒炒牛肉	菜膽炒牛
菜椒	燈籠椒
菜瓜	勝瓜	水瓜
菜籃	餸籃
菜花	椰菜花
菜苔	菜心
菜薊	雅枝竹
菜飯	餸飯
菜餚	餸	餸菜
菜鳥	新嚟新豬肉
菠蘿蜜	大樹菠蘿
華人	唐人
華而不實	有姿勢冇實際
菲傭	賓妹	賓賓
菲力牛排	牛柳
菲力豬排	豬柳
菲力雞排	雞柳
菲力魚排	魚柳
菲律賓人	賓佬	賓婆
菲律賓少女	賓妹
菲律賓少年	賓仔
菲籍女傭	賓妹
萌芽	標芽
萬一	慢下手
萵苣	唐生菜	生菜
落	漏	跌
落下	漏低
落下了	漏咗
落下了東西	漏低	漏咗
落下來	跌落嚟
落井下石	趁佢病，攞佢命
落伍	out
落在最后	包尾
落地	跌落地
落後	盟塞	第屘
落枕	瞓戾頸	瞓捩頸
落榜	肥佬
落泊	霉
落淚	流馬尿
落湯雞	水雞
落空	堝
落葵	潺菜
落魄	人唔似人，鬼唔似鬼
葉子	葉
著了邪	中咗邪
著名的藝人	大老倌
著急	喉急	心急	著緊
著涼	冷嚫	冷親	凍嚫	凍親
著火	火燭
著火啦！	火燭喇
葡式奶油塔	葡撻
葡式蛋塔	葡撻
葡萄	提子	菩提子	葡提子
葡萄乾	提子乾
葡萄酒	菩提酒
葫蘆	蒲瓜
葵花子	葵瓜子
葷的	雜
葷菜	雜菜
葷食	雜
蒂	椗
蒙	摟
蒙在鼓裡	懵閉閉
蒙著面	幪面
蒙面	幪面
蒜末	蒜蓉
蒜泥	蒜蓉
蒸牛肉末卷粉	牛肉腸粉	牛腸
蒸米粉卷兒	腸粉	豬腸粉
蒸蝦末卷粉	鮮蝦腸粉
蒸飯	盅頭飯
蒼蠅	烏蠅
蓋	扱	摟	𢫏
蓋子	蓋
蓋得很嚴	扱得好冚
蓋得很緊	笠實	笠實晒	笠緊
蓋房子	起屋
蓋碗	焗盅
蓋碗兒	焗盅
蓋碗兒底下的托兒	焗盅薦
蓋章	扱印	抌印
蓋著	笠住
蓋蓋子	𢫏蓋
蓋被子	𢫏被
蓋（房子）	起
蓓蕾	冧	花冧
蓮花白	椰菜
蓮茸	蓮蓉
蓮蓬頭	花灑
蔑視	睇衰
蔓越莓	金啤梨
蕁麻疹	風赧
蕃薯	番薯
蕩婦	姣婆
蕹菜	通心菜
蕾	冧
薄乎乎的	薄切切	薄英英
薄烤餅	班戟
薄煎餅	班戟
薄薄的	薄切切	薄英英
薄餅	薄罉
薑泥	薑蓉
薛丁格的貓	薛定諤的貓
薤	藠頭
薩克斯管	色士風
薩克斯風	色士風
薪水	人工	糧
薪水很低	人工好奀
薪金	人工
薯蕷	淮山
藉故偷懶	懶人多屎尿
藍圖	圖則
藍姆酒	冧酒
藍莓	藍啤梨
藏	收	柄
藏在哪裡	收喺邊度
藏起來	匿埋	收埋
藕斷絲連	挐挐褦褦
藤箱	藤喼
藤箱提手	藤喼耳
藤藤菜	通心菜
藤鞭	藤條
藤鞭子	藤條
藥丸	丸仔
蘇打	梳打
蘇打粉	梳打粉
蘇打餅	餅乾
蘋果派	蘋果批
蘑菇	冬菇
蘭姆酒	冧酒
蘸	點
蘸酱油	點豉油
蘿蔔乾	菜脯
蘿蔔青菜各有所愛	各花入各眼
虎頭蛇尾	冇手尾	有頭冇尾	有頭威冇尾陣
處	忽
處女	青頭女
處所	埞	忽
處理	跟
處男	青頭仔
處罰	罰
處處	度度	通處	頭頭
虛假的	花假
虛偽的	花假
虛偽的客氣	讕客氣
虛弱	孱
虛弱多病的孩子	孱仔
虛張聲勢	抛浪頭
虛有其表	有姿勢冇實際
虛有其表的	花假
號令	笛
號兒	籌
號碼	冧巴
號脈	把脈	揞脈
虧了大本	蝕晒大本
虧心	陰騭
虧心事	陰騭事
虧損	蝕
虧本	蝕本	蝕錢
虧本生意	蝕本生意
虧本貨	蝕本貨
虧本貸款	蝕本貸
虧錢	蝕錢
虹	天虹	彩虹
蚊咬	蚊𧕴
蚊子	蚊	蚊螆
蚊子叮傷	蚊𧕴
蚊子幼蟲	沙蟲	蚊蟲
蚌	蜆
蚜蟲	菜螆	螆
蚯蚓	黃䘆	黃犬
蚱蜢	草蜢
蛀牙	爛牙
蛋	春
蛋塔	蛋撻
蛋奶酥	梳乎厘
蛋糕	戟
蛋羹	水蛋
蛙泳	蛙式
蛙蟹	老虎蟹
蛤蜊殼	蜆殼
蛤蜊肉	蜆肉
蜂巢	蜂竇
蜂窩	蜂竇
蜂蜜	蜜糖
蜂蠟	蜜蠟
蜇	針
蜈蚣	百足
蜘蛛	蠄蟧
蜘蛛網	蠄蟧絲網
蜜罐	蜜糖埕
蜷縮	屈
蜻蜓	塘尾
蝎子	蠍
蝙蝠	蝠鼠	飛鼠
蝦	蝦公
蝦卵	蝦春
蝦塊兒	蝦轆
蝦子	蝦
蝦段兒	蝦轆
蝦爬子	賴尿蝦
蝦蛄	賴尿蝦
蝦蛄頭	老虎蟹
蝦醬	鹹蝦
蝨子	蝨乸
蝶泳	蝶式
螃蟹	大閘蟹	蟹
螞蟥	蜞乸	黃蜞
螞蟻	蟻
螞蟻窩	蟻竇
螢幕	銀幕
螳螂	馬螂狂
螳螂蝦	賴尿蝦
螺旋槳	車葉
螺旋鉗	士巴拿
螺絲刀	螺絲批
螺絲起子	螺絲批
螺螄	田螺	螺
螻蛄	土狗
蟋蟀	織蟀	蟀
蟑螂	小強	曱甴
蟒蛇	蝻蛇
蟣子	蝨乸春
蟬	沙蟬
蟬蛻	沙蟬殼
蟲牙	爛牙
蟲膠	士叻
蟹卵	蟹春
蟹子	蟹春
蟹鉗	蟹弶
蟻窩	蟻竇
蟾蜍	蛤蟆	蠄蟝
蠓蟲	蚊螆
蠔油炒嫩菜心	蠔油菜薳
蠕動	貢
蠢	戇喪
蠢得很厲害	死蠢
蠢笨	人頭豬腦	低B	吽	笨實	薯嘜	薯頭
蠢豬	薯頭
蠢貨	福頭	茂尼
蠢鈍	豬兜
蠶卵	蠶春
蠻	幾
蠻不講理	刁蠻	棖雞	牛精	番鬼	發爛渣
蠻便宜	幾平
蠻好	幾好
蠻快	幾快
蠻橫	刁蠻	牛王	牛精	發爛渣
蠻橫無理	狼戾
蠻過份	幾過份
血	紅
血本無歸	大出血
血管爆裂	爆血管
血豆腐	豬紅
行	OK	得	攪掂
行不行	得唔得
行不通	唔work
行不通的辦法	屎坑橋	屎坑計
行乞	揸兜
行了	得喇
行動緩慢	湆懦懦	湆手湆腳
行動電話	手提
行就吃龍蝦	得就得，唔得就翻順德
行李廂	車尾
行李箱	皮喼	車尾箱
行為不軌	伊挹
行為詭秘的人	攝青鬼
行蹤飄忽的人	攝青鬼
術士	南無佬
街坊	隔籬鄰舍
街坊鄰里	街坊
街妓	企街
街巷的盡頭	巷篤
街段	街口
街道旁邊	街邊
衛生巾	M巾	姨媽巾	親戚巾
衛生棉	M巾	姨媽巾
衛生紙	廁紙	草紙
衛生衣	波恤
衝	標
衝出	標出
衝出來	標出嚟
衝出去	標出去
衝浪	滑浪
衝浪板	滑浪板
衝突	嗌霎	拗撬
衝進來	衝入嚟
衝過去	衝埋去
衣兜	衫袋	袋
衣冠不整	咧啡	咧氣
衣字旁兒	禮衣邊
衣扣	衫鈕
衣服	衫	衫褲
衣服的內層	襯裏
衣服的裏子	衫裏
衣服破了	衫爛咗
衣服破爛	爛身爛勢
衣服裡子	衫裡
衣架	衫架
衣櫥	衣櫃
衣著光鮮	身光頸靚
衣袋	衫袋	袋
衣袖	衫袖
衣補兒	禮衣邊
衣食無憂	安樂茶飯
衣食父母	米飯班主
表情	口面
表情呆滯	木口木面
表揚	讚
表明	講到明
表演	做騷
表現自己	攞彩
表親	老表
表露出來	出面
表面	外皮
表面皺	巢皮
表面起皺紋	巢皮
袋子	袋
袖子	衫袖
被	畀
被…	…親
被人偷盜	爆夾	爆格
被人害苦	畀人玩死
被人搶劫	畀人箍頸
被人敲了一筆竹槓	畀人斬到一頸血
被人編造罪名	畀人砌
被人陷害	畀人砌
被人騙了	畀人棍咗
被傳染	惹
被出賣了	畀人賣豬仔
被別人壓住	畀人踩
被別人戳脊梁骨	畀人唱衰
被別人詆毀	畀人唱衰
被別人陷害	屈餐懵
被刮了一下	揩親
被刺刺著	劖親簕
被叮了	啄親
被問倒	畀問起
被單	被冚
被困	韞
被困在升降機內	韞猎
被困在電梯裡面	韞猎
被套	棉胎
被子	被
被宰了一筆	畀人斬到一頸血
被寵壞的孩子	生骨大頭菜
被慣壞了	畀錫壞咗
被打入冷宮	畀雪藏
被打敗	畀人拼沉
被打死	打瓜
被扣押	扮蟹
被拒絕	食檸檬
被捆綁	扮蟹
被捆起來	扮蟹
被撞得青一塊紫一塊的	瘀晒
被收買了	做豬仔
被槍斃	焫咗
被氣得不得了	激到好嬲	激到泵泵聲	激到爆	激到甩肺
被氣得火冒三丈	眼火爆
被氣火兒了	激到爆
被水淹	水浸	沉親
被水淹死	畀水沉死
被水淹沒	水浸
被碰了一下	揩親
被窩	被竇
被竊	爆夾	爆格
被絆	撠
被絞決	問吊
被罵	畀人鬧
被罵得一錢不值	畀鬧到一戙都冇
被罵得垂頭喪氣	畀鬧到一隻屐	畀鬧到死死吓
被罵得滿臉羞慚	畀鬧到一面屁
被罵得無地自容	畀鬧到一面屁
被罵得狗血淋頭	畀鬧到一戙都冇	畀鬧到一隻屐	畀鬧到一面屁	畀鬧到死死吓
被考倒	畀考起
被考倒了	考起
被處絞刑	問吊
被褥	被鋪
被解顧	執包袱
被誘騙	賣豬仔
被誣賴	屈餐懵
被警察逮捕	畀差人拉
被軋了	轆親
被辭退	執包袱
被迫地	死死氣
被迫服從	大石責死蟹
被開水泡熟了	淥熟晒
被電到	電親
被騙	畀人呃	畀人棍咗
被鬼附身	鬼上身
被鬼附體	鬼上身
裁紙	鎅紙
裂開	坼	爆
裏子	衫裏	裏	襯裏
裙子	半截裙	短裙	裙
補	補數
補上	補翻
補償	補數
補助費	補水
補回	補翻
補幾針	聯幾針
補救	執生	摱	箍煲
補救失誤	補鑊
補漏	執漏
補貼	補水
補貼家裡的開支	补家用
補路	整路
裝	扮	詐
裝不下	裝唔落
裝不牢	裝唔穩
裝作	扮	詐諦
裝作沒事	扮冇事
裝作沒聽見	扮聽唔到
裝修師傅	裝修佬
裝傻	扮傻扮懵	扮懵	扮蠢	詐傻	詐呆詐吽	詐戇	面懵心精
裝傻充愣	詐癲扮傻
裝入	入
裝出一副冷酷的樣子	扮晒cool
裝可愛	扮得意	扮純情
裝好人	扮好人
裝愚笨	詐呆詐吽
裝成有錢人	充闊佬
裝模作樣	作狀	扮代表	扮嘢	扮晒嘢	擺晒款
裝模裝樣	詐詐諦諦
裝樣子	扮嘢	裝假狗
裝死	詐死
裝病	詐病
裝瘋扮傻	搏傻
裝瘋賣傻	扮傻扮懵	扮癲扮傻	扮蠢	詐傻	詐傻扮懵	詐癲扮傻	詐癲賣戇
裝瘋賣傻來佔便宜	扮豬食老虎
裝睡	扮瞓	詐瞓
裝神弄鬼	扮鬼	整古做怪
裝笑	扮笑
裝糊塗	扮傻扮懵	扮懵	扮蠢	詐傻	詐傻扮懵	詐懵
裝純真	扮純情
裝置	set
裝聾作啞	詐耳聾	詐聾扮啞
裝腔作勢	作狀	詐型
裝著東西	裝住嘢
裝蒜	扮嘢	裝假狗	詐諦
裝進	入
裡出外進	岩岩巉巉
裡裡外外一把手	出得廳堂，入得廚房
裡邊	入便	入面	埋便	裏便	裏底	裡便	裡面	裡頭
裡邊兒	埋便
裡面	入便	入面	埋便	裏便	裏底
裡頭	入便	埋便	裏便	裏底
裸露出	打出
裹小腳	紮脚	紮腳
裹腳	紮脚	紮腳
製造假結果	造馬
複印	影印
複印機	影印機
複寫紙	碳紙	過底紙
複查	跟
複習	溫書
複習功課	溫功課
褐色	啡色
褥子	床薦	薦褥	褥
褪色	甩色
褲兜	褲袋
褲兜兒	褲袋
褲子	褲
褲子口袋	褲袋
褲子口袋兒	褲袋
褲帶	褲带	褲頭帶
褲腰	褲頭
褲腿	褲腳
褲襠	褲浪
褲襪	襪褲
襟姪	姨甥
襠	浪
襪子	襪
襪子布偶	襪公仔
襪子玩偶	襪公仔
襯衫	恤衫
襯裏	裏
襯裙	底裙
西式甜點	西餅
西式糕餅	西餅
西式糕點	西餅
西式茶點	西餅
西式蛋餅	奄列
西式點心	西餅
西方電影	西片
西曬	西斜	西斜熱
西洋人	番鬼	番鬼佬	老番	西人
西洋參	花旗參
西洋小孩	番鬼仔
西洋旱芹	西芹
西洋梨	啤梨
西洋的	番鬼
西洋芹菜	西芹
西瓜籽	西瓜核
西瓜籽兒	西瓜核
西紅柿	番茄
西紅柿汁	茄汁
西紅柿醬	茄汁
西裝	老西
西裝畢挺	西裝骨骨
西裝革履	西裝骨骨
西邊	西便
西點	西餅
要	使	想	愛
要上廁所	人有三急
要不	一係	唔係嘅話
要不得	唔要得
要不然	一唔係	唔係嘅話	要唔係
要不要	使唔使	要唔要
要人家老命	食人隻車
要人的命	收買人命
要價太高	食水太深
要命	交關	攞命	死死吓	瓜得	飛起	鬼死
要嘔吐	作嘔
要好的朋友	死黨
要我當挨罵的	搵我做醜人
要打要殺的	打打殺殺
要是	若果	若然	若然之
要求大	開胃
要緊	緊要
要緊的事	緊要事
要講節儉	食得唔好嘥
要錢要得太狠	食水太深	食水深
要錢要得太黑	食水深
要飯	乞食	揸兜
要飯的	乞兒
要麼	一係	一唔係
要麼…要麼…	一係…一係…
覆盆子	公飯
覆蓋	幪
覆蓋物	笠
見不得人	唔見得人
見不得人的	鬼五馬六
見不得光	唔見得光
見不著	見唔到
見仁見智	各花入各眼
見外	生外
見機行事	睇餸食飯
見牙不見眼	見牙唔見眼
見異思遷	花心
見著	見到
見血	見紅
見誰學誰	有樣學樣
見識不多	未見過大蛇屙屎
見面	撞面
見風使舵	趁風使𢃇
見鬼	撞鬼
覓食	搵食
親	啜嘴	親生
親一下	咀一啖	錫一啖
親吻	咀	咀嘴	啜嘴	打茄輪	打車輪	錫嘴
親哥哥	親生大佬
親嘴	啜嘴	打茄輪	激嘴	錫	錫嘴
親嘴兒	啜嘴
親姐妹	親生姊妹
親姐姐	家姐
親密合作	同撈同煲	同煲同撈
親密無間	糖黐豆
親愛的	打令
親戚朋友	親朋戚友
親手做菜	親自下廚
親朋好友	親朋戚友
親臉蛋	啜面珠	錫面珠墩
親臉頰	錫面珠墩
親自做事	親力親為
親自動手	落手落腳	親力親為
親自幹	親力親為
覺察	醒水
覺得	覺	認住
覺得怎麼樣	覺點
觀光車	旅遊巴
觀星	睇星
角	毫	毫子
角落	角落頭
解僱信	大信封
解僱通知	大信封
解決	攪掂
解釋	解
解釋不了	解釋唔到
解釋簽上的文字	拆簽	解簽
解釋電影的內容	解畫
解開疙瘩	解纈
解開結	解纈
解除了負擔	一身鬆
解雇	炒	炒魷	炒魷魚	燉冬菇
解餓	頂肚	頂肚餓
觸摸	玷
觸碰	玷
觸電	電親
觸電致死	電瓜
觸類旁通	話頭醒尾
言出必信	牙齒當金使
言歸於好	箍煲
言無二價	一口價
言而無信	下扒輕輕	口輕輕
言語	笛
訂不到座兒	book唔到位
訂座兒	book位
訂房間	訂房
訂機票	book機票
訂貨單	柯打
訂酒店	book酒店
計劃在內	預埋
計劃生育	家庭計劃
計程車	的士
計程車司機	的士佬
計策	橋	計仔
計算	計	計數
計算器	計數機
計算在內	打
計算機	計數機
計算機科學	compute	電腦科學
計謀	橋
計較	拘執	計帶
討	乞
討人厭	乞人憎	得人憎	犯眾憎	篤眼篤鼻	篤鼻
討人喜愛	抵錫
討人嫌	乞人憎	得人憎
討人嫌的人	騎呢𧊅
討便宜	搲著數	搵著數	攞便宜
討債	收數
討債人	收數佬
討價	講數
討價還價	講數口
討厭	乞人憎	唔開胃	好衰㗎	得人憎	憎	抵死
討厭鬼	衰公	衰鬼	衰鬼豆
討回公道	攞翻公道
討彩頭	攞意頭
討紅包	豆利是
討賬	追數
討飯	乞食	揸兜
討飯的	乞兒
訓	㨘
訓斥	㨘
記下來	記低
記不清楚	醒唔起
記不起來	水過鴨背
記事本	記事簿
記在帳內	入數
記在帳本上	入數
記得	記住
記性	耳性
記性差	冇記性
記憶力差	冇耳性	冇記性	水過鴨背
記著	記住
記號	交叉	記認
記起	醒
訟務律師	大律師	大狀
設圈套	裝彈弓
設定	set
設定好	set好
設宴	擺酒
設置	set
設置好	set好
許多	多多聲
訴訟	告
訴訟律師	大律師	大狀
訴訟律師的副手	師爺
診治	睇症
診脈	把脈	揞脈
註定	整定
詆毀	嘥
詐騙	棍	滾	造馬
評論家	批評家
試一下運氣如何	搏一鋪
試拍	試鏡
試探	探盤
試穿	試身
試衣	試身
試試看	試吓
詭計	貓招
詭計多端	蠱惑
話	偈	笛	說話
話不投機	傾唔埋
話又說回來	話時話
話可要說回來	話時話
話多	口多多	口水多過茶
話筒	咪	咪高峰
話說回來	講翻轉頭
話說回頭	講開又講
話雖如此	係就係
話音未落	話口未完
該	抵
該倒霉	當衰
該怎麼辦	點算好
該打	抵打
該揍	抵打
該死	抵死
該死的	打靶佬	打靶鬼	斬頭鬼	死人頭
該死的人	抵死友
該罰	抵罰
該罵	抵鬧
詳情	detail
詼諧	生鬼	鬼馬
誆人	棍人
誆騙	棍
誇下海口	爆響口
誇大	作大
誇大別人的不是	煮米	煮重米
誇張	作大
誇獎	讚
誇耀	拋書包	招積	花弗
誇誇其談	口響	唱口	牙擦	牙擦擦
認不出來	認唔到
認不得	唔認得
認乾親	上契	契
認倒霉	認衰仔
認出來	認到
認命	揸頸就命
認帳	認數
認得	識得
認得出	認得
認死理	死牛一便頸
認清別人	帶眼識人
認為	認住
認真	君真	落力	落足
認真嘗	試真啲
認真看	睇真啲
認真看清楚	落足眼力
認真考慮	諗真啲
認股證	窩輪	輪
認識	認得	識	識得
認識路	識路
認輸	認低威
認錯	知衰
誘人	激凸
語無倫次	窒口窒舌	鬼上身
誣告	老屈
誣衊	老屈
誣賴	屈	老屈
誣賴別人	屈佢食隻死貓
誤會	搭錯線	擺烏龍	會錯意	表錯情
誤解	會錯意	表錯情
誤點	過鐘
誦讀困難	讀寫困難
誦讀障礙	讀寫困難
說	話	講
說一下	話聲
說三道四	口臭	噏三噏四	講三講四
說下去	講落去
說下流話	講爛口
說不出口	講唔出口
說不出話	唔出得聲	喉嚨拆晒
說不定	唔定	話唔定
說中	話中	講中
說了算	揸弗	話事
說人是非	講是非
說人的壞話	煮米	煮重米
說什麼	講咩
說什麼也沒用	乜都假
說什麼話	乜嘢話
說什麼？	乜嘢話？	你講咩嘢話？	咩話？
說來聽聽	講嚟聽吓
說來話長	有故講咯	講起一匹布咁長
說來說去	講嚟講去
說個不停	口噏噏	雞啄唔斷
說倒是容易	講咁易咩
說假話	講假
說再見	講拜拜
說出來	講出嚟
說到做到	講得出做得到
說到底	假假哋	話晒	講到尾
說句不好聽的	好話唔好聽
說句公道話	講句公道說話
說句心裡話	問心嗰句	講心嗰句
說句難聽點的話	大吉利事講句
說啥也不行	乜都假
說多巧有多巧	有咁啱得咁蹺
說夢話	發喑話	發開口夢
說好	話定	講定
說好聽的話	賣口乖
說定	話定	講定	講實
說定了	一於
說實在的	問心嗰句	好話唔好聽	講心嗰句
說實話	講真
說幾句話	講幾句說話
說廢話	講耶穌
說得也是	講得啱
說得天花亂墜	講到天花龍鳳
說得好聽	口響	講得口響	賣口乖
說得對	講得啱
說得明白	話到明	講到明
說得板上釘釘的	講到實牙實齒
說得難聽一點	好話唔好聽
說悄悄話	傾密偈
說故事	講故	講故仔
說教	講耶穌
說明	寫到明	解
說明白	話到明	講到明	講明
說昏話	發喑話
說時遲那時快	話都冇咁快
說書人	講古佬
說書藝人	講古佬
說曹操	日頭唔好講人，夜晚唔好講鬼
說沒影兒的事	煲冇米粥
說法	講法
說清楚	話到明	講到明	講明
說的也是	噉又係
說的沒錯	講得啱
說真心話	問心嗰句	講心嗰句
說穿了	無他
說粗話	媽媽聲	爆粗	爆粗口	講爛口	講粗口
說粗話罵人	講粗口鬧人
說著說著	傾傾吓
說話	talk	出聲	講嘢	講話	開聲
說話下流	爛口
說話不對頭	口臭
說話不算數	冇口齒
說話句句是假	冇句真	講嘢冇句真	講嘢都冇句真	講嘢都冇句真嘅
說話含糊不清	黐脷根
說話圖一時之快	貪口爽
說話有點兒大舌頭	黐脷根
說話沒個完	講話好似雞啄唔斷噉	雞啄唔斷
說話沒有一句是真	講嘢冇句真	講嘢都冇句真	講嘢都冇句真嘅
說話算數	有口齒	牙齒當金使
說話粗鄙下流	粗口爛舌
說話結結巴巴	口震	嘍口
說話走了火	講漏嘴
說謊	吹水	講大話
說走了嘴	講漏嘴
說起	講起	講開
說起來	講起	講起上嚟	講起又講	講開	講開又講
說起這個話題	講開
說錯話	講錯嘢
說長論短	講三講四
說順口溜	數白欖
誰	乜人	乜嘢人	乜水	乜誰	亞誰	邊個
誰不知道？誰不知道哇	鬼唔知咩
誰也不欠誰	為威喂
誰也不認識誰	三九唔識七
誰也受不了	佛都有火
誰叫你…？	鬼叫你…
誰料	點知
誰料到	點知
誰曉得	鬼知
誰的	邊個嘅
誰的？	邊個㗎
誰知	誰不知	鬼知	點知
誰知道	點知
誰誰	亞乜人
誰都	係人都
誰都不	係人都唔
誰都會發火的	佛都有火
誰都知道	係人都知
課室	班房
調	扭	摳
調到正確	校啱
調到準	校啱
調味	校味
調均勻	攪勻
調子	調
調情	伊挹
調戲	非禮
調戲女孩子	嫽女仔
調戲婦女	摸身摸勢
調整	較
調查	跟
調準	校啱
調準時間	校啱時間
調班	調更
調皮	刁僑扭擰	反斗	奀皮	扭紋	擒騎	曳	百厭	跳皮
調皮得要命	曳到死
調皮搗蛋	星君
調皮的小孩	馬騮精
調皮蛋	反斗星
調皮鬼	嘩鬼	奀皮鬼	扭紋柴	扭計大王	扭計祖宗	死仔	衰仔
調節	較
調職	過檔
調色	校色
調轉	撈亂
調配顏色	校色
調頭寸	撲水
談	傾	斟
談一下	傾吓	斟吓
談不下去	傾唔落去
談不來	傾唔埋	傾唔掂
談不妥	傾唔掂	斟唔掂
談不攏	傾唔埋	傾唔掂	傾唔掂數	冇偈傾	唔啱傾
談何容易	容乜易
談個沒完	起勢傾
談公事	傾公事
談判	斟盤	講數
談天	傾偈
談好	傾掂
談妥	傾掂
談得來	傾得埋
談得投機	啱牙
談心	傾密偈	傾心事
談心裡話	傾心事
談情說愛的	埕埕塔塔
談戀愛	拉手仔	拍拖	拖手仔
談生意	傾生意	斟盤
談話	傾偈	嗲
談談	斟吓
請	唔該
請不要少見多怪	有乜咁出奇
請人幫忙	班兵
請人捉刀	請槍
請人槍替	請槍
請假	告假
請吃宴席	請飲
請吃酒席	請飲
請問	借問聲
請問一下	借問一聲	借問聲
請喝喜酒	請飲
請客	請飲
請帖	紅色炸彈
請慢慢…	慢慢
請慢慢吃	慢慢食
請慢走	慢慢行
請打手	使橫手
請援兵	班兵
請教	偷師
請求援助	班兵
請病假	放大假
請讓一讓	企歪啲	借一借	借借	借歪	借歪啲
請讓路	借借
請辭	唔做
請進	入嚟啦
論	斷
論…賣	斷…賣
論個兒賣	斷隻賣
論斤賣	斷斤賣
諷刺	單單打打	嘥	攞景	潤	瘀	諦
諸事不順	行步路打倒褪
諸位	咁多位
謀生	搵食	搵飯食	撈世界
謊稱	呃稱
謊言	大話
謊話	大話
講人情	講人事
講信用	牙齒當金使	講口齒
講冷笑話	攪爛gag
講得不清楚	口湆
講情面	講人事
講故事	講故	講故仔
講究	姿整
講笑話	攪gag
講話不清不楚	講嘢鬼食泥咁
講課	講書
講電話	傾電話
謝了	多謝喎
謝罪酒	和頭酒
謝謝	唔該	唔該晒	多謝	好話
謝謝了	多謝喎
謝謝您關心	有心
謝謝關心	有心
謹言	口密	密實
證件	紙
證明書	cert	紙
證書	cert	紙
識別力	sense
識別好人壞人	帶眼識人
識相	識做
識破	識穿
識趣	通氣
警務處處長	一哥
警句	金句
警員	PC
警官	亞sir	散仔	老散
警察	大頭綠衣	差人	差佬	散仔	皇氣	綠衣	老散	阿Sir
警察局	差館
警察巡官	沙展
警察樣板	差辦
警察機動部隊	PTU
警察臨檢	查牌
警察辦案	差人做嘢
警方	皇氣
警笛	銀雞
警覺	醒定	醒水
警醒	醒瞓
警長	柴頭
護壁板	腳線
護士	姑娘	看護
護照	passport
護花使者	觀音兵
護著	傍
護衛員	secu	實Q	看更	石Q
變不回	變唔翻
變了味	有味
變卦	縮沙
變回	變翻
變壓器	火牛
變形	殽
變換	改轉
變質	堝
變速箱	波箱
讓	畀	等
讓乘客下車	落客
讓人罵	畀人鬧
讓人識破	畀人識穿
讓別人欺負了	畀人恰
讓我來	等我嚟
讓我看看	等我睇吓
讓警察抓去	畀差人拉
讚揚	讚
请人下馆子	請人飲茶	請人飲餐茶
豁亮	光猛
豁出去	拚	死就死
豁出去了	一鋪翻唐山	幾大就幾大	幾大就幾大，燒賣就燒賣	拚咗佢
豁出去了！	幾大就幾大喇
豁嘴	崩口
豆乾	豆膶
豆子	豆
豆干	豆腐膶
豆沙	豆蓉
豆泡	豆腐泡
豆泥	豆蓉
豆漿	豆奶
豆瓣葉	西洋菜
豆瓣醬	麵豉
豆粉	生粉
豆腐乳	腐乳
豆腐干	豆腐膶
豆腐腦	豆腐花
豆腐腦兒	豆腐花
豆芽	芽菜
豆薯	沙葛
豇豆	豆角
豈止	點止
豌豆	荷蘭豆	青豆
豎	戙	掂
豎紋	掂紋
豎腿	戙腳
豎著	打掂
豎著寫	打掂寫
豐乳	隆胸
豐富	頂籠
象甲	穀牛
象鼻子	象拔
豪豬	箭豬
豪賭	搏殺
豬下水	豬雜
豬前腿	豬手
豬後腿	豬腳	豬踭	豬踭肉
豬排	豬扒
豬排包	豬扒包
豬排飯	豬扒飯
豬油	豬膏
豬窩	豬竇
豬肘子	豬踭	豬踭肉
豬肝	豬潤
豬胰	橫脷	豬橫脷
豬脾	橫脷	豬橫脷
豬腎	豬腰
豬腎臟	豬腰
豬腰子	豬腰
豬腳薑	薑醋
豬腳薑醋	薑醋
豬腸子	粉腸
豬舌頭	豬脷
豬菲力	豬柳
豬血	豬紅
豬血湯	豬紅湯
豬血粥	豬紅粥
豬蹄	豬腳
豬蹄子	豬腳
豬蹄膀	豬踭	豬踭肉
豬雜碎	豬雜
豬食	潲	豬潲
豹子	豹
貌美出眾	標青
貓窩	貓竇
貝雷帽	巴黎帽
負不了責任	孭唔起
負主要責任	擔綱
負總責	擔綱
負荷	佗	受力
負責	揸手	跟
負起一切責任	孭飛
財主	闊佬
財務長	財務總監
財產	身家
財迷心竅	發錢寒
貧嘴薄舌	口花花	牙斬斬
貨梯	貨猎
貨樣	辦
貨物	貨仔
貨物與樣品不符	貨不對辦
貨色	貨仔
貨車板	貨卡
貨運升降機	貨猎
貨運電梯	貨猎
販賣毒品	賣白粉
販賣毒品的場所	白粉檔	粉檔
貪便宜	貪平	貪着數
貪吃	為食	爛食
貪圖	貪
貪圖漂亮的形象而損害健康	愛靚唔愛命
貪圖省力	諗縮數
貪威	攞彩
貪婪地盯著	眼甘甘
貪新鮮	新屎坑，三日新	新屎坑，三日香
貪污受賄	扒錢
貪玩	爛玩	爛蒲
貪玩的人	蒲友	蒲精
貪玩的女孩	𠿭妹
貪生怕死	錫身
貪睡	爛瞓
貪舒服	貪自在
貪色的年輕闊少	花心大少
責備	徇
貴公司	大寶號	寶號	貴寶號
貴婦	富太
貴號	大寶號	寶號	貴寶號
貴重	矜貴
貶低自己	認衰仔
貶得一錢不值	嘥到一錢不值
貶損	唱
買	幫襯
買下	買低
買下來	買低
買不到票	買唔到飛
買便宜貨	執平嘢
買保險	買燕梳
買公寓	買樓
買到退票	執死雞
買單	埋單
買夜宵	買宵夜
買得過	抵買
買房子	買屋	買樓
買束花	買紮花
買東西	行公司	買嘢
買樓房	買樓
買票	買飛
買空賣空	炒買炒賣
買舊貨	執二攤	揸二攤
買菜	買餸
買藥	執茶	執藥
買衣服	睇衫	買衫
買賣人	生意佬
買賣興隆	發市
買賬	埋單
買路錢	行水
買退票	執死雞
買進	入貨
貸款買房	按揭
費力	抵力
費力把事拖	拉布
費勁	抵力
費勁心力	捱生捱死
費口舌	勞氣
費唇舌	勞氣
費工夫	揼工
費心血	嘥心機
費時間	揼	揼工
費用	使用	使費
費用高	重皮
費神	勞氣	嘥心機
費腦筋	禁諗
費話	勞氣
貼在告示板作示范	貼堂
貼身跟隨	跟到實
貼身防守	跟到實
賀卡	賀咭
賀年卡	新年咭	賀年咭
賀款	人情
賀禮	人情
資料	料
資歷	quali
資歷淺	未夠班
賊	賊佬
賊巢	賊竇
賊眉鼠眼	蛇頭鼠眼
賊贓	老鼠貨
賊頭賊眼	蛇頭鼠眼	蛇頭鼠腦
賒欠	賒住先	賒數
賒賬	賒住先	賒數
賓館	酒店
賞	醒
賞你的	醒你嘅
賞封	封包
賞臉	畀面	賞面
賞賜	打賞
賠不起	賠唔翻
賠命	填命
賠本	蝕本
賣二手貨的店舖	夜冷舖
賣俏	放生電	放電	發姣
賣光	賣晒
賣出	賣埠
賣力	落力
賣力氣	落力
賣勁兒	落力
賣古玩的商店	古玩舖
賣命	搏晒命	搏老命
賣報的	報紙佬
賣完	賣晒
賣座	爆棚
賣弄	曬嘢	演嘢
賣弄學問	拋書包
賣弄風情	放生電	放電
賣清涼茶的店	涼茶舖
賣股票虧錢	炒燶咗
賣身去做苦工	賣豬仔
賤	爛賤
質料	質地
質次	化學
質量不算高	不過不失	麻麻
質量差	化學	水	水皮	豆泥	鮓	鮓斗	鮓皮
質量差的東西	水嘢
質量差的貨物	水貨
質量很差	好化學
賬簿	數簿
賭一下膽識	搏大膽
賭一盤大的	搏鋪大
賭一賭運氣	搏吓彩
賭博	搏殺
賭博攤子	大檔	賭檔
賭客	賭仔
賭徒	賭仔
賭攤	大檔	賭檔
賭棍	賭仔
賭氣	使頸	鬥氣	鬥負氣
賭球	賭波
賭膽識	搏大膽
賭膽量	搏大膽
賭馬輸了錢	鋪草皮
賴	曳
賴皮	奸貓	奸賴	矛	矛賴	賴貓
賴著不走	賴死
賴賬	撻數
賺不了錢	賺唔到錢
賺了一大筆錢	撈到盤滿缽滿	賺到盤滿缽滿
賺了很多利潤	盤滿缽滿
賺取外快	秘撈
賺得多	好賺
賺得太狠	食水太深	食水深
賺錢	搵銀	搵錢
賺錢多	食水深
購物	掃貨
購置產業	置業
購買地產	置業
賽普勒斯	塞浦路斯
賽跑	鬥走
賽車	鬥車
賽馬	跑馬
賽馬場	馬場
賽馬資料	馬經
賽龍舟	鬥龍船
贏回	贏翻
贗品	朱義盛	朱義盛貨	流嘢
赤條條	光脫脫
走	扯	行	走人	趲	鬆人
走一步看一步	見一步，行一步	見步行步
走一步算一步	見一步，行一步	見步行步
走一走	行吓
走不了	唔行得
走不動	行唔喐
走不掉	走唔切
走不開	唔行得開	行唔開
走之兒	艇仔
走之底	撐艇仔	艇仔	艇仔邊
走了火	滑咗雞
走了調兒	走晒音
走人	著草	趯佬	鬆人	鼠
走出來	行出嚟
走出去	行出去
走動	喐動	走趯
走吧	走囉
走回去	行翻去
走失	蕩失
走好	慢慢行
走好運	行大運
走廊	冷巷
走後門	行後門
走得動	行得起
走得快	雞噉腳
走投無路	冇埞走
走捷徑	行近路
走水客	水客
走江湖	行蠱惑	走埠
走江湖的	江湖佬
走為上策	早走早著
走為上著	早走早著
走秀	行騷
走私海洛因	走粉
走私白粉	走粉
走私貨	水貨
走繩索	踩軟索
走纜繩	踩軟索
走背運	行衰運	運滯	黑
走著瞧	睇住嚟
走調兒	走音
走路	行路
走路不穩	舂吓舂吓	舂瘟雞
走路時突然停一下	窒腳
走路都摔跤	人衰行路打倒褪
走近道	行近路
走進來	行入嚟
走進去	行入去
走運	執到寶	夠運	行運
走遍	行勻
走遍全國	行勻全國
走過了頭	行過籠
走過來	行埋嚟	行過嚟
走過去	埋去
走鋼絲	踩軟索
走錯了地方	錯蕩
走錯門	錯蕩
走開	死開	行開	過主
走開！	行開啲啦
赴宴	去飲
起不了床	起唔到身
起作用	殺食
起來	起上嚟	起嚟	起身
起先	頭頭
起初	初不初	初初	初時	初頭	起先	起頭	頭頭
起動器	士撻膽
起司	芝士
起司堡	芝士漢堡
起司蛋糕	芝士蛋糕
起名	改名
起子	泡打粉
起床	起身
起眼	覺眼
起程	起錨
起繭子	起枕
起腱子	起腱
起訴	告
起誓當白饒	誓願當食生菜
起趼子	起枕
起鍋兒	起鑊
起閧	攞景
起雞皮	毛管戙
起雞皮疙瘩	毛管戙	起雞皮
起風	翻風
起鬨	㗾
起點站	總站
趁他病取他命	趁佢病，攞佢命
趁便	趁手
趁機	借啲意
趁火打劫	搏亂
趁熱吃	監熱食	趁熱食
趁熱打鐵	趁風使𢃇
趁著	監
趁著時機	揸住時機
超時	過鐘	開O.T.
超時工作	O.T.
超群	標青
超越範圍	過界
超越邊界	過界
超過	過籠
超過了時間	過鐘
超過界線	過界
越位	恰西
越來越	越嚟越
越來越有勁地	起勢	起勢噉
越吃越想吃	越食越開胃
越弄越糟	整衰晒
越想越惱火	越諗越火滾
越想越生氣	越諗越火滾
趕	趲
趕…走	趕…扯
趕上	追翻
趕不上	唔及得
趕不回來	翻唔切
趕不回去	翻唔切
趕人回家	趕扯
趕人走	趕扯
趕他走	趕佢扯
趕得及	得切
趕忙	啦啦林	啦啦聲	快快脆脆
趕快	啦啦林	啦啦聲
趕時間	趕時候
趕時髦	好潮
趕緊	啦啦聲	嗱嗱臨	快啲	快脆	擒擒青
趕走	趕扯
趕路	起勢行
趕過來	趕過嚟
趕集	趁墟	趁墟打市
趕集日	墟日
趕鴨子上架	拉牛上樹
趟	仗
足夠	夠皮	夠算
足夠了	夠晒
足球解說員	講波佬
趴	仆	伏
趴下	仆低	伏低
趴下來	仆低
趴在桌子上	仆喺張枱度
趴著睡	仆住瞓
趼子	枕
趾高氣揚	串	咁串
趿拉著鞋	撻住對鞋
跌	躀	𢴈
跌倒	笪	跌低	跌親	跌跤	跣低	躀低	𢴈
跌跌撞撞	一仆一碌
跌跤	躀	躀跤
跑	走	趯
跑不了	唔走得
跑不動	走唔起
跑不快	走唔起
跑不掉	走唔切	走唔甩	趯唔切
跑不贏	趯唔切
跑了調	走晒音
跑來跑去	撲嚟撲去
跑出來	走出嚟
跑出去	走出去
跑到隔壁躲懶	蛇咗去隔籬
跑去	走去
跑單幫的	水客
跑堂的	企堂
跑娛樂新聞的記者	娛記
跑得太慢了	趯唔切
跑掉	著草	走人	走路	趯佬
跑掉了	走甩咗
跑氣	漏氣
跑腿	走趯
跑腿的	散仔
跑調	走音
跑跑跳跳	扎扎跳	跳扎扎	跳跳扎
跑進來	走入嚟
跑進去	走入去
跑過來	走過嚟
跑過去	衝埋去
跑酷	飛躍道
跑電	走電
跑龍套	茄喱啡
跛子	亞跛	跛腳佬
跛行	趷
距離	隔
跟	共	同	挐	踭
跟…商量商量	同…斟吓
跟…有染	同…有嘢
跟…有關係	同…有嘢
跟…沒有關系	唔關…事
跟…沒關係	唔關事
跟…無關	唔關…事
跟…見面	見…
跟…談談	同…斟吓
跟他拼了	同佢搏過
跟他較量一番	同佢搏過
跟別人一樣	學人
跟在後面	跟尾
跟在後頭	跟尾
跟女人鬼混	滾
跟屁蟲	跟尾狗
跟得上	跟得切
跟愛人吃飯	撐枱腳
跟斗	大翻	關斗
跟著	嚟緊	跟住	跟手	連隨
跟著幹	睇頭
跟蹤	跟到實
跟這沒關係	唔關事
跟隨	跟	跟到實	跟尾
跟頭	大翻	關斗
跨	[諵]	擸
跨過去	諵過
跪下	跪低
跪拜時的墊子	跪薦
路不順	撠腳
路口	街口
路子	路數
路費	水腳
路邊攤	攤檔
路邊的小吃攤檔	大牌檔
跳下	跳落
跳下來	跳落	跳落嚟
跳下去	跳落去
跳動	趲
跳房子	跳飛機
跳格子	跳飛機
跳棋	波子棋
跳槽	過檔
跳水	插水
跳蚤	狗蝨	跳蝨
跳蚤市場	跳蝨市場
跳起	扎
跳起來	扎起	跳起身
跳踢踏舞	跳的達舞
跳進	跳入
跺	𨂽
跺腳	𨂽地	𨂽腳
踉蹌	舂吓舂吓
踏	𨅝
踏破	踩爆
踐踏	戮
踝子骨	腳眼
踝襪	龍船襪
踢	𨅝
踢一腳	𨅝一腳
踢毽子	搓燕	踢燕
踢球	踢波
踢足球	踢波
踢踏舞	的達舞
踩	戮	跴	𨅝
踮腳	䟴	䟴高
踮起腳	䟴高腳
踵	踭
踹	𨅝
踹一腳	𨅝一腳
蹊蹺	蹺妙
蹓躂	蒲開
蹦極跳	笨豬跳
蹦蹦跳跳	扎扎跳	生蝦噉跳	跳扎扎	跳跳扎
蹬	𨅝
蹬腿兒	伸直咗	伸直腳	兩腳一伸
蹭	姿整	揩
蹭吃蹭喝	黐飲黐食
蹭花	揩花
蹭飯	黐飯餐	黐餐
蹭飯吃	黐飯餐	黐餐
蹲	踎
蹲下	踎低
蹲下身體	踎低身
蹲在家裡	屈喺屋企
蹲式廁所	踎廁
蹲班	㨆班	重讀
蹲監獄	扽監	踎監
蹲著	踎低身
蹲馬桶	踎塔
躍躍欲試	手痕
躡手躡腳	思思縮縮
躥出來	標出嚟
躥出去	標出去
身	脫
身不由己	洗濕個頭	洗濕咗個頭
身子動來動去	喐身喐勢
身子搖來搖去	搖身搖勢
身孕	身紀
身強力壯	身壯力健
身懷六甲	粗身大細
身材	身型
身材很標緻	身材好弗
身正不怕影子斜	行得正，企得正
身無分文	拍手無塵	窮到燶	週身冇蚊
身無長物	拍手無塵	窮到燶
身負重任	孭重飛
身邊沒有現錢	荷包糠	荷包糠糠哋
身體	身子
身體不適	頭暈身㷫	頭暈身熱
身體健康	身壯力健
身體很棒	食得做得
身體潺弱的人	虧柴
身體發熱	身㷫
身體虛弱	孱
躲	匿	縮	避
躲到哪裡去？	匿去邊度？
躲到房間裡去了	匿入房
躲懶	偷雞	蛇	蛇王
躲藏	匿
躲起來	匿埋
躲躲閃閃	閃閃縮縮
躺	攤
躺下	瞓低
躺倒	撻
躺椅	懶佬椅
車子	車
車子拋錨了	架車死咗火
車子的鑰匙	車匙
車庫	車房
車廂	卡	火車卡	車卡	車尾
車本	車牌
車皮	卡	火車卡
車票	車飛
車禍	撞車
車胎	肽	車肽
車胎打滑	跣肽
車胎放炮	爆肽
車費	車飛
車軲轆	車轆	轆
車輪	車轆	轆
車輪子	車轆	轆
車輪打滑	跣肽
車鑰匙	車匙
軋	轆
軋傷	轆親
軟	削	腍
軟墊子	箍臣
軟弱	畀人蝦
軟弱無力	軟笪笪
軟心豆粒糖	啫喱豆
軟木塞	枳	樽枳
軟木塞兒	枳	樽枳
軟滑	爽手
軟片	菲林
軟綿綿	腍啤啤	軟荏荏
軟綿綿的	軟腍腍
軟而不韌	削坺坺
軟軟的	削	削笪笪	軟笪笪
軟飯	爛飯
軲轆	車轆	轆
較量	過招
較量一番	搏過
載	車
載貨電梯	貨猎
輔助輪	輔助轆
輕佻	姣
輕型貨車	van	貨van
輕巧	的式
輕浮	塵	沙塵	浮	白霍
輕浮驕傲	沙塵白霍
輕而易舉	閒閒哋
輕聲細氣	陰聲細氣
輕薄	索油
輕視	看低	睇低	睇小	睇衰
輕視別人	嘴喵喵
輕觸	玷
輕言細語	陰聲細氣
輕輕洗	揸水
輪	轆
輪不到你	唔到你
輪子	車轆	轆
輪帶	車肽
輪沙蟲	禾蟲
輪流	輪住
輪流值班	輪住值班
輪班	輪更
輪胎	肽
輪胎破了	爆肽
輸個精光	輸晒
輸光	輸晒	食白果
輸定了	輸梗
輸得一貧如洗	輸到七個一皮
輸得精光	輸到七個一皮
輾	轆
輾轉拜託	托上托
輾轉相託	托上托
轉	擰
轉來轉去	兜嚟兜去	揗嚟揗去
轉動	扭喐
轉彎	掟彎
轉得很快	轉得好衡
轉換新的工作	轉工
轉暖	回南
轉業	轉行
轉筆刀	筆刨
轉舵	扭軚
轉螺絲	擰螺絲
轉託	托上托	搭上搭
轉賬	過數
轉身	擰轉	擰轉身	擰轉頭
轉過身來	擰過身嚟
轉過身去	厲轉身
轉過頭來	擰過頭嚟
轉颳南風	回南
轎車	房車
辛苦了	辛苦晒
辛苦你了	辛苦晒
辣得難受	揦脷
辣辣的	辣辣哋
辣魚三明治	辣魚多
辦	攪
辦不到	做唔到	做唔掂	夜啲啦	攪唔掂
辦事	做嘢
辦事失敗	倒竈
辦事情不爽快	湆手湆腳
辦事疲沓的人	軟皮蛇
辦公大樓	寫字樓
辦公樓	寫字樓
辦善事的機構	善堂
辦喜事	拉埋天窗
辦好	攪妥	攪掂
辦妥	攪妥	攪掂
辦得到	攪得掂
辦法	把炮	橋	符	符弗	計	計仔
辦酒席	擺酒
辨別不出好壞	牛噍牡丹
辭工	執包袱
辭職	唔撈	擗炮	炒老細魷魚	辭工
辮子	孖辮	辮仔
辯論	鬥駁
農曆	舊曆
迅速	啦啦林	啦啦聲	快手	快手快腳
迎	照
迎頭	照頭
迎頭澆	照頭淋
近來	呢排	呢期	呢輪	呢駁	近排
近道	近路
近鄰	街坊
返	翻
返場	安哥
还好	好在
迪斯科	的士高
迫不及待	急不及待
迫近	埋身
迴旋	走趲
迴紋針	萬字夾
迴避責任	過橋
迷人	索
迷你紅蘿蔔	甘筍仔
迷戀	冧
迷戀者	發燒友
迷糊	混沌
迷路	蕩失	蕩失路
迷路了	蕩失
迷迷糊糊	混混沌沌	迷迷懵
追債	追數
追求	吼
追求女孩子	溝女
追男人	溝仔
追討欠款	追數
追隨	跟
追隨不捨	死跟
退	褪
退休	收山
退後	褪後
退後一點	褪後啲
退後幾步	褪幾步
退步	褪步
退熱	退㷫
退燒	退㷫
退瓶子	回樽
退瓶費	回樽費
退縮	縮沙	褪舦	褪軚
退錢	回水
送	車
送人	做手信
送喜糖	派糖
送報紙	派報紙
送禮	做人情
送給	送畀
送給鄰居親友	派街坊
送賀禮	做人情
逃	散水
逃不掉	走唔甩
逃亡	著草	走路	趯更
逃命	趯更
逃學	偷雞	走堂
逃脫	走甩
逃脫了	走甩咗
逃走	散水	著草	趯佬
逃跑	著草	走路	趯
逃跑也來不及了	走都走唔切
逃難	走難
逆耳	哽耳
逍遙自在	䟴䟴腳
透不過氣來	一條氣	透唔到氣
透徹	通透
透支	碌爆
逗	嘍	嫽	趣致	鬥
逗人	嗿人
逗人喜愛	cute
逗人喜歡的	趣致
逗女生	嫽女仔
逗小孩	鬥細佬哥
逗弄	嫽
這	今	依	呢
這一位	呢位
這一種	呢樣
這一輩子	呢世	呢世人
這一邊	呢頭
這一陣	呢排
這一陣子	呢排
這不是明擺著嗎	擺到明
這些	依啲	呢啲
這些天	呢排
這些日子	今時今日
這些日子真不順當	呢排好唔掂
這些東西	呢啲嘢
這件事	呢單嘢
這件事與你無關	唔關你事
這位	呢位
這個	依個	呢個
這個人	呢條友
這個品種	呢停
這個地方	呢一度
這個星期	今個禮拜	呢個禮拜
這個時候	呢個時候	呢陣時
這個月	今個月	呢個月
這個月底	今個月尾
這個東西	呢嘢
這個禮拜	今個禮拜	呢個禮拜
這個那個	乜乜物物
這傢伙	呢個嘢	呢條友	呢隻嘢
這兒	依度	呢處	度
這回	今回	呢勻	呢輪
這回糟了	呢次弊
這小子	呢條友
這就	即
這就是為什麼…	…噉解
這幾年以來	呢幾年嚟
這是	呢個係
這時	呢個時候
這會兒	呢陣	家下	家陣
這樣	噉	噉樣
這樣來理解	…噉解
這樣做就對了	噉就啱
這樣做就糟糕了	噉就弊
這樣吧	不如噉
這樣子也好	噉都好
這樣就對了	噉就啱
這樣就糟糕了	噉就弊
這樣幹也不行嗎	噉都唔得
這樣幹也行？	噉都得
這樣的	呢停	呢樣
這樣的事情	呢味嘢
這樣還不行嗎	噉都唔得
這樣還成？	噉都得嘅？
這樣那樣的	乜乜物物
這樣都行？	噉都得
這次	今勻	今回	今次	今鋪	依次	呢勻	呢輪	呢鋪
這款	呢停	呢款
這款車	呢停車
這段時間	呢駁
這種	依種	呢停	呢樣	呢款	呢種
這種事	呢味嘢	咁嘅嘢
這種事情	呢槓嘢
這種人	呢停人
這種東西	咁嘅嘢
這裡	依度	呢一度	呢度	呢處	呢頭
這路人	呢停人
這輩子	呢世	呢世人
這週	今個禮拜	呢個禮拜
這還了得	噉仲得掂
這還成？	噉都得嘅？
這還行？	噉都得嘅？
這邊	呢便	呢頭
這陣子	呢排	呢輪
這頭	呢頭
這麼	咁	噉
這麼久了	隔咗咁耐
這麼做	咁做
這麼多年	咁多年
這麼巧	咁啱
這麼巧呀	有咁啱得咁蹺
這麼晚	咁晏
這麼晚才來	咁遲先嚟
這麼樣	噉樣
這麼絕	咁盡
這麼著	係噉話	噉樣
這麼說來	噉又點
通	穿
通力合作	拍硬檔
通宵	通頂
通常	通拉
通徹	通透
通情達理	熟性	通氣
通書	通勝
通澈	通透
通的	通窿
通菜	通心菜
通融	搭路
通通	一腳踢
通過	派司	透過
通鋪	太平鋪
通電話	傾電話
通順	通掂
通風報信	通水
逛商店	行公司
逛夜市	行夜市
逛大街	行街
逛百貨公司	行公司
逛花市	行花市	行花街
逛街	去街	行街
逛逛商店	行吓公司
逝世	歎元寶蠟燭	過身	釘	釘蓋	香
逞強	認叻	認掯
逞能	認叻	認掯	讕架勢
逞英雄	認掯
速食麵	公仔麵
造反	作反
造孽	冇陰功	陰功	陰騭
逢集	墟日
連	打埋
連…也包括在內	打埋
連…也包括進去	打埋
連…也算上	打埋
連同	合
連喘口氣都困難	氣都透唔到
連夜	漏夜
連夜幹	漏夜做
連夜幹活	漏夜做
連夜進城	漏夜入城
連接	駁	駁住
連接起來	駁
連滾帶爬	一仆一碌
連環畫	公仔書
連翻倒霉	死人兼冧屋
連衣裙	衫裙
連褲童裝	蛤乸衣
連褲襪	襪褲
連襟	老襟
連連續續地走霉運	頭頭碰著黑
連鍋端	一鑊熟
逮	捉
逮住	捉住
逮個正著	䁓到正
週末	禮拜尾
進	入
進了棺材了	釘咗蓋
進了腰包	落袋
進來	入嚟
進來吧	入嚟啦
進來坐	入嚟坐
進剪票口	入閘口
進去	入到去	入去
進口的	來路
進口貨	來路貨
進屋裡坐	入房坐
進帳	落袋
進球	入樽
進監獄	食皇家飯
進貨	入貨
進退兩難	半天吊
進進出出	行出行入
逼迫	監
遇事盲目	行路唔帶眼
遇到麻煩	乃嘢	乃大鑊	乃鑊	大鑊
遇見	撞翻
遊山	行山
遊戲室	打機室
遊戲機室	打機室
遊戲機店	打機室	機室	機舖
遊手好閒的人	散仔
遊歷	遊埠
遊玩	遊船河
遊覽車	旅遊巴
遊覽車又稱觀光車	旅遊巴司機
運動衣	士缽恤	波恤	波衫	體育衫
運動衫	T恤	笠記	過頭笠
運動褲	波褲
運動鞋	波缽	波鞋
運氣	彩数	彩數
運氣不好	當黑	黑
運氣壞	運滯
運氣好	好彩数	好彩數
運氣差	當衰
運費	水腳
遍	勻
過一會兒	聽暇
過一會兒動一下	喐吓喐吓
過一段日子	第日
過不了	過唔到
過不去	過唔去
過世	上咗路	仙遊	去咗賣鹹鴨蛋	去賣鹹鴨蛋	埋單	歎元寶蠟燭	落下面	行先一步	賣鹹鴨蛋	過身	釘	釘蓋	香
過世了	仙遊咗	去咗	去咗遊埠	瓜咗	瓜老襯	移咗民	走咗	釘咗	釘咗蓋	香咗	𢫏國旗	𢫏旗
過了	過咗火
過了一會兒	過咗陣
過了一段時間	過咗一排	過咗陣
過了時間	過晒鐘
過了這村沒那店	蘇州過後冇艇搭
過了頭	過咗火	過籠
過了點	過晒鐘	過鐘
過些日子	第日	遲吓
過些時候	遲吓
過份	過火
過份了	過咗火
過份講究打扮	支支整整
過來	埋嚟	過嚟
過冬節	過冬
過冬至	過冬
過冬至節	做冬
過冬至節比過年還重要	冬大過年
過分	得滯
過分…	…過頭
過分擁擠	爆晒棚
過分謙虛	謙虛過頭
過去	埋去	往日	舊底	舊日	舊時	舊陣時
過家家	扮煮飯仔	煮飯仔
過幾天	第日	過幾日
過後	聽暇
過得去	不過不失	麻麻哋
過於	得滯
過於…	…過頭
過時	out	老土	過鐘
過時間	過鐘
過濾	隔
過濾渣滓	隔渣
過熟了	熟得滯
過癮	爽	貪得意
過的橋比你走的路還多	食鹽仲多過你食米
過磅	磅
過節	做節
過苦日子	捱番薯	捱白飯	紮炮
過辣	揦脷
過道	冷巷
過關	度橋	諗橋	過骨
過雲雨	白撞雨
過頭	過火	過籠
過頭了	過籠
過鹹	揦脷
道具	架罉
道士	南無佬
道觀	齋堂
道賀	贈慶
達到目的	得米
達到頂點	頂籠
達官	大粒
違章建築	僭建
違規停車	違例泊車
遙控器	遙控
遙遙無期	浸死鴨乸	浸死鴨乸咁耐
遛狗	放狗
遜色	輸蝕
遞給	遞畀
遠來的和尚會念經	本地薑唔辣
遠處	冇雷公咁遠
遠足	行山
適合使用	啱使
適合吃	啱食
適合玩	啱玩
適合看	啱睇
適應新情況	馬死落地行
適用	啱使
遭不幸	折墮
遭天譴	天收佢
遭天遣的	畀天收
遭殃	當衰
遭水淹	水浸
遭水災	水浸
遭遇悲慘	折墮
遮不住	遮唔住
遮掩	幪
遲	夜	晏
遲到	遲晒
遲遲鈍鈍	木木獨獨
遲鈍	吽	木獨	笨實	薯嘜	話頭唔醒尾	豬兜	鈍
遷就	就
遷就他一下	就吓佢
選	揀
選擇	揀
選購衣物	睇衫
選錯了職業	入錯行
遺囑	平安紙
遺尿	賴尿
遺漏	漏	漏低	賴
遺留	賴
遺留下來	賴低
遺留下的麻煩事	蘇州屎
遺留的棘手問題	蘇州屎
避嫌	避忌
避孕套	套	安全套
避諱	避忌
避風港	避風塘
邀約	嘍
邁	[諵]	擸
還	仲	仲兼	仲加	重
還不	未
還不夠資格	仲未夠班
還不如…	仲冇咁嬲
還不是	仲唔係
還不是嗎	仲唔係
還不知道	未知	都未知
還不行	仲唔得	未得	未得住
還以為	仲估
還在調查	查緊
還在這兒	仲喺度
還在這裡	仲喺度
還在那兒	仲喺度
還在那裡	仲喺度
還好	幾好
還小	仲細
還想怎樣	仲想點
還早著呢	未有耐
還是	一係	仲係	定	定係	抑或	都係
還是不	都係唔
還是不…吧	都係唔
還是老樣子	仲係噉	冇穿冇爛
還是這樣子	仲係噉
還有	仲有
還有一段時間	未有耐
還有好長時間才	未有耐
還有很長時間	有排
還有沒有	仲有冇
還沒	仲未	未	都未
還沒做好	仲未掂	仲未攪掂	未掂
還沒到	仲未到
還沒弄好	未掂
還沒成	未得	未得住
還沒有	未曾
還沒有弄好	仲未掂	仲未攪掂
還沒有睡醒	未瞓醒
還沒辦妥	仲未掂	仲未攪掂	未掂
還活著	仲生
還湊合	不過不失	麻麻	麻麻哋
還用問	仲使問
還用問？	唔使問阿貴
還用說	仲使講
還給	畀翻
還要	仲要
還要好	仲好
還要糟糕	仲弊
還說	仲話
還錢	畀翻錢
邊	便
邊…邊…	一住…一住…
邊界	界
那	嗰
那一位	嗰位
那一夜	嗰一晚
那一段日子	嗰排
那一邊	嗰頭
那一陣子	嗰排	嗰輪
那些	嗰啲
那些日子	嗰排
那些東西	嗰啲嘢
那件事	嗰單畸士
那位	嗰位
那個	嗰個
那個人	嗰個人
那個傢伙	嗰條友
那個地方	嗰處
那個壞傢伙	嗰隻衰嘢
那個壞東西	嗰隻衰嘢
那個小子	嗰條友仔
那個時候	嗰排	嗰時	嗰輪	嗰陣	嗰陣時
那倒不是	噉又唔係
那倒不是的	噉又唔係噃
那倒是	又係	噉又係
那兒	嗰處	度
那又怎樣？	噉又點	噉又點呀？
那又怎麼樣？	噉點呀？
那天	嗰日
那天晚上	嗰晚
那就不同	噉又唔同
那就不是	噉即唔係
那就對了	噉就啱
那是	嗰個係
那時	嗰時	嗰輪	嗰陣
那時候	嗰時	嗰輪	嗰陣	嗰陣時
那晚	嗰晚
那有金子嗎？	有金執咩
那樣	噉	噉樣
那次	嗰次
那當然	使乜講
那種	嗰種
那裡	嗰度	嗰處	嗰頭	邊邊
那還用說	使乜講
那邊	嗰便	嗰處	嗰頭
那陣子	嗰排	嗰輪	嗰陣
那頭	嗰頭
那麼	咁	噉
那麼…	咁鬼死…
那麼多年	咁多年
那麼巧	咁啱
那麼絕	咁盡
邦迪	藥水膠布
邪門	邪
郊遊	行山
郵票	士擔
郵遞員	信差	郵差
都	晒	添
都係唔…了	都係唔
都在	喺晒
都市	城
都抄下來了	記低晒
都明白了	明晒
都是	都係
都是因為	皆因
都算完了	計晒
都記錄好了	記低晒
都鬧翻天了	攪到滿天神佛	滿天神佛
鄉巴佬	大鄉里	鄉下仔	鄉下佬	鄉下妹	鄉下婆
鄰居	街坊	隔籬	隔籬鄰舍
鄰里	街坊
鄰里一場	一場街坊
配	襯
配合	合檔	拍檔
配料	料
配藥	執茶	執藥	落藥
酒	傻仔水
酒吧女服務員	吧女
酒喝多了	飲大咗
酒曲	酒餅
酒水部	水吧
酒瓶	酒樽
酒窩	酒凹	面凹
酒精	消毒火酒	火酒
酒罈	酒埕
酒罈子	酒埕
酒藥	酒餅
酒飯錢	茶錢	飲茶錢
酒鬼	醉貓
酗酒	劈酒	爛酒
酥脆	鬆化
酥軟	腍
酪梨	牛油果
酵母	伊士	酒餅
酷	cool	型	有型
酷斃	型到痺
酷斃了	型爆
酸凝酪	乳酪
酸奶	乳酪
酸溜溜	酸微微
酸牛奶	乳酪
酸痛	淵	淵痛
酸痛得要命	淵到死
酸痛死了	淵到死
酸臭	宿	酸酸餿餿
酸菜	鹹菜
酸酸的	酸微微	酸酸哋
酸黃瓜	黃瓜酸
醃橄欖	欖角	欖豉
醃臘熟食	燒臘
醃臘熟食店	燒臘舖
醃製	醃
醃製果子	涼果
醃製酸菜	醃鹹菜
醃酸菜	醃鹹菜
醃酸黃瓜	黃瓜酸
醃鹹鴨蛋	醃鹹蛋
醇厚	掯
醉了	貓咗	醉咗	飲大咗兩杯
醉漢	醉貓	醉酒佬
醉鬼	爛酒佬	醉貓	醉酒佬
醋缸子	醋埕
醋罈子	醋埕
醒來	醒嚟	醒翻
醒悟	醒起
醒目	威水
醜	樣衰	肉酸	醜怪	醜樣	難睇
醜事	衰嘢
醜八怪	拗胡	拗胡婆
醜樣	樣衰
醜話說在前頭	大吉利事講句
醜陋	兜踎	核突	樣衰	醜怪	醜樣
醫生	醫師
醬油	抽油	白油	豉油
醬油瓶	豉油樽
醬油碟子	豉油碟
醬瓜	茶瓜
醬肉	鹵味
醬豆腐	南乳
醬雞	豉油雞
醯胺	酰胺
釋放出獄	出冊
重大	𠹳
重大事情	𠹳嘢
重建	再起
重提	提翻
重新思考	諗翻轉頭
重新打鼓另開張	拆棚做過
重活	粗重嘢
重症監護室	深切治療部
重要	緊要
重要事情	緊要事
重逢	撞翻
重重地摔了一跤	笪生魚
重體力勞動	粗重嘢
野	喪
野丫頭	妹頭	牛王妹
野蠻	牛精	矛	矛賴
野豬	山豬
野豬穴	山豬竇
量	度
量入為出	睇餸食飯
量力而行	冇咁大個頭唔好戴咁大頂帽
量力行事	睇餸食飯
量身	度身
量身訂做	度身訂造
量錯	度錯
量體溫	探熱
量體裁衣	睇餸食飯
量體訂做	度身訂造
金勞力士手錶	金撈
金勞力士腕錶	金撈
金勞力士錶	金撈
金器店	金舖
金屬罐	鋁罐
金店	金舖
金玉其外	有姿勢冇實際
金環蛇	金腳帶
金線魚	紅衫	紅衫魚
金線鯉	紅衫	紅衫魚
金線鰱	紅衫	紅衫魚
金行	金舖
金酒	氈酒
金針菇	金菇	金菇菜	金錢菇
金針菜	金針
金錢	銀	錢銀
金鐲	金鈪
金鐲子	金鈪
金魚眼	凸眼
釘	聯
釘上扣子	聯翻粒鈕
釘子	釘仔
針管	針筒
針腳	線步
鈔票	水	紙	銀紙
鈔票貶值	銀紙縮水
鈕扣	衫鈕	鈕
鈴	唥鐘
鈴兒花	吊鐘
鈴聲	唥
鈴鐺	唥鐘
鈴響	唥
鉗	弶
鉗子	弶
鉛筆刀	筆刨
鉤子	鉤
鉸鏈	鉸
銀屑病	牛皮癬
銀河	天河
銀耳	雪耳
銀耳甜湯	雪耳糖水
銀行資金積壓	銀行水浸
銜著	擔住
銳利	利
銷魂	索
鋁	銻
鋁合金	飛機銻
鋁盆	銻盆
鋁箔	錫紙
鋁箔紙	錫紙
鋁鍋	銻煲
鋒利	利
鋥亮	擸擸炩	擸炩	炩	炩擸擸
鋪蓋	被鋪
鋪路修橋	修橋整路
鋸	鎅
鋸末	木碎	木糠
鋸齒	鋸牙
鋸齒狀的	狗牙
鋸齒邊	狗牙邊
鋼材	先頭
鋼筆	墨水筆
鋼筆尖兒	筆嘴
鋼筋	鋼骨
鋼筋水泥	鋼骨水泥
鋼精鍋	銻煲
鋼絲	威也	威吔
鋼鏰兒	碎銀
錄下	錄低
錄下來	錄低
錄像機	攝錄機
錄取供詞	落口供
錄口供	落口供
錄影盤	鐳射影碟
錐子	錐
錘子	錘
錢	水	銀	銀紙	錢銀
錢不夠花	錢唔夠使
錢包	荷包	銀包
錢少	糠	荷包糠
錢幣	銀
錢財	水
錯就錯在	弊就弊在
錯怪	怪錯
錯過	嘥
錯過機會	漏雞	走雞
錶瓤	錶肉
錶芯	錶肉
鍋	煲	罉
鍋巴	飯焦
鍋手柄	煲耳
鍋把	煲耳
鍋把手	煲耳
鍋柄	煲耳
鍋的提手	煲耳
鍋碗瓢盆	砂煲罌罉
鍋蓋	飯蓋
鍋鏟	鑊鏟	飯鏟
鍋飯	煲仔飯
鍾錶店	時間廊
鎖上	鎖	鎖住
鎖上了	鎖咗
鎖上門	鎖門
鎖住	鎖實
鎖住了	鎖實咗
鎖著	鎖住
鎖起來	鎖住
鎖邊	鈒骨
鎮	治
鎮定	定當	淡定	老定
鎮定一點	定啲	定啲嚟	淡定啲
鎮定自若	定過抬油
鏈接	連結
鏡子	鏡
鏡框	相架
鏽	鍟
鐘錶店	錶行
鐘點傭工	鐘點	鐘點工
鐘點兒女工	鐘點女傭
鐮刀	禾鐮
鐲子	鈪
鐳射	雷射
鐵價不二	一口價
鐵公雞	算死草
鐵匠	打鐵佬
鐵合頁	鉸
鐵打師傅	跌打師傅
鐵柵欄	鐵閘
鐵柵門	鐵閘
鐵棍	鐵通
鐵水管	水喉通
鐵管	鐵通
鐵管兒	水喉通
鐵管子	水喉通	水喉鐵	鐵通
鐵絲	鐵線
鐵路	火車路
鐵鍋	鑊
鐵門	鐵閘
鑄模	倒模
鑰匙	鎖匙
鑽	捐	貢	錐
鑽來鑽去	貢吓貢吓	貢嚟貢去
鑽山洞	捐山窿
鑽法律空子	走法律罅
鑽石勞力士錶	鑽撈
鑽研	咪	咪書
鑽空子	搏亂
鑽進	捐入	貢入
長	長流流
長不大的孩子	大細佬
長假	大假
長假期	大假
長凍瘡	生蘿蔔
長凳	橋凳
長出腱子肉	起腱
長口瘡	生飛螆
長大	大個
長大了	大個仔	大個仔囉	大個咗	大個女	有毛有翼
長大的女孩	大個女
長大的孩子	大個仔
長官	亞sir
長寄生小蟲	生螆
長寄生蟲	生蟲
長尾夾	魚尾夾
長帶狀疱疹	生蛇
長得	生得
長得好看	生得好睇
長得帥	生得靚仔
長得挺漂亮的	生得幾靚
長得漂亮	生得靚
長得美	生得靚
長得醜	生得醜
長期	枕住	枕長
長板凳	橋凳
長滿了草	生晒草
長滿了鏽	生晒鍟
長痱子	生熱痱	生瘡
長皮膚病	生螆
長眼睛	帶眼
長篇大論	水蛇春咁長	煲電話粥
長米蟲	生穀牛
長米象	生穀牛
長繭子	起枕
長肉	生肉
長膿包	生瘡
長蝨子	生蝨乸
長袖運動服	波恤
長象甲	生穀牛
長鏽	生鏽
長霉	發毛
長青春痘	生暗瘡
長頭癬	生瘌痢
長骨刺	生骨刺
長高	標高
門	閘
門口	門
門合頁	門鉸
門折頁	門鉸
門牌	冧巴
門的鑰匙	門匙
門縫	門罅
門衛	看更
門路	窿路	路數
門鈴	門鐘
門鉸鏈	門鉸
門鑰匙	門匙
門齒	門牙
閃	縮
閃了腰	屈親條腰
閃得快	縮得快
閃爍	閃閃炩
閃著	閃閃吓
閃閃發亮	閃閃炩
閉	眯	閂
閉上一隻眼	單眼
閉上眼睛	眯埋眼	眯埋雙眼	瞌埋眼	闔埋雙眼
閉嘴	收口	收嗲	收聲
閉塞	盟塞
閉眼	瞌	闔眼
閉著嘴巴	眯埋個嘴
閉著眼睛	眯埋雙眼
閉著眼睛走南牆	隔山買牛
閉起一隻眼	單眼	單起隻眼
開	揸
開不了口	講唔到
開出租汽車	揸的士
開出租車	揸的士
開到天亮	開到通頂
開創者	開荒牛
開動	開身
開口	開聲
開口笑	沙翁
開口閉口	開口埋口
開夜車	戙起床板	捱更抵夜
開始	起首	開鑼
開始做買賣	開盤
開始打麻將	開檔打牌
開始拍攝	埋位
開始有所收穫	開齋
開始演唱	開騷
開始表演	開騷
開始說起話來	講起上嚟
開小差	偷雞	蛇王	趯更
開市	發市	開舖	開舖頭
開店	開檔
開張	開檔
開心	合皮	爽
開心大笑	笑騎騎
開戒	打爛齋缽
開拓者	開荒牛
開拖拉機	揸拖拉機
開攤兒	開檔
開支	使用	使費
開水	滾水
開水龍頭	開水喉
開溜	偷雞
開燈	著燈
開玩笑	反	講笑
開球	開波
開罐器	罐頭刀
開胃	醒胃
開舞會	開P	開派對
開船	開身
開行	開身
開裂	爆坼
開襠褲	開浪褲
開計程車	揸的士
開走	揸開
開車	揸車
開辦慈善機構	開善堂
開進去	車埋去
開金	K金
開銷	使用	使費
開門	開舖	開舖頭
開門營業	開舖	開舖頭
開開眼界	開吓眼界
開閘	打掣
開閘通電	打掣
開闊視野	開眼界
開關	掣
開頭	起先	起頭	頭頭
開高級轎車	揸靚車
開齋	打爛齋缽
閒心	風流
閒情逸致	風流
閒扯	打牙骹
閒玩	蒲開
閒聊	傾閒偈	打牙骹
閒聊天	傾閒偈
閒蕩無事	迆
閒話	閒偈
閒談	傾偈	吹水	打牙骹	發牙痕	閒偈
閒適	他條
間或	間中
間隔	隔
間隔一天	諵日
間隙	卡罅
閘門	閘
閣樓	閣	閣仔
閥門	喉嘴
閨女	囡囡
閱讀資料	睇料
閱讀障礙	讀寫困難
閹過的公雞	騸雞
閹雞	鏾雞	騸雞
閻王賬	貴利
闊少爺	亞斗官	亞鬥官
闊氣	闊佬
闊氣的人	大頭鬼	闊佬
闌尾	橫丫腸
闔家	闔府
闔家安康	闔府安康
闖	舂
闖江湖	撈世界
闖禍	倒米
闖紅燈	衝燈
闖蕩	蒲
闖進來	衝入嚟
關	閂	韞	骨
關上	閂
關上窗戶	閂窗
關上門	閂埋度門	閂埋門
關不嚴	閂唔實	閂唔死
關不牢	閂唔死
關係	挐褦
關係密切	拍膊頭
關卡	骨
關好了	閂到實	閂實
關店門	閂舖
關心	著緊
關押	韞
關機	熄機
關照	帶挈	睇住
關燈	熄燈
關禁閉	韞入黑房	韞黑房
關起來	韞
關起門來	閂埋度門	閂埋門
關進黑房	韞入黑房
關門	收舖	閂門
闢邪	治邪
闹翻天	炒大鑊
防寒	抵冷
防彈衣	避彈衣
防裂油	爆坼膏
阻攔	阻
阻止不了	阻唔到
阿	亞
阿三	摩羅叉	阿星
阿伯丁	鴨巴甸
阿姨	姨	姨姨
阿飛	串仔	飛仔
附帶說一下	話時話
附身	上身
附近	就近	左近
陌生	生暴
陌生人	生暴人
降	治
降價	減價	跌價
降職	燉冬菇
限制	制
限制供水	制水
陡	斜
陡坡塌方	冧山泥	山泥傾瀉
陣	朕
陣子	輪
陣容大	大陣仗
陣雨	白撞雨	過雲雨
除了	除咗
除了…之外	除咗…之外
除了…之外還…	除咗…之外仲…
除了…以外	除咗…之外
除夕	年卅晚
陪伴	傍
陪睡	陪瞓
陰囊	春袋
陰戶	閪
陰暗	翳
陰毒	陰騭
陰莖	㞗	何B仔	姑姑	子孫根	弟弟	祠堂	第三隻腳	第五肢	細佬	脧	脧脧	脧脧仔	賓舟	雀仔	𡳞	𨳍
陰陽人	半男女
陰陽先生	風水佬
陰陽生	風水生
陰險	陰	陰濕
陰險奸詐	奸狡
陰險毒辣	陰毒
陳米的氣味	糠
陶醉	冧
陷	凹
陷入	凹
陷入困境	踢晒腳	踢腳
陷入窘境	踢腳
陷害	屈	整古	砌	累死	老屈	跣
陷害人	跣西瓜皮
陷害別人	屈佢食隻死貓	屈得就屈	裝彈弓
陷進去了	洗濕咗個頭
陽台	露台	騎樓
陽春麵	淨面	淨麵
隆重	大陣仗
隊排得很長	人龍	條人龍
隊長	隊目
階級鬥爭	鋤大弟
隔一段時間	久不久	耐不耐	耐中	耐唔中	耐唔耐	耐耐
隔了一夜的	隔夜
隔了一夜的茶	隔夜茶
隔了一夜的茶不能喝	隔夜茶唔飲得
隔了這麼長時間	隔咗咁耐
隔出	橺
隔出一個房間來	橺一間房
隔壁	隔籬
隔壁房間	隔籬房
隔壁鄰居	隔籬屋
隔開	橺
障眼法	揞眼法
障礙	阻滯
隨他便吧	由佢喇	由得佢喇
隨你便	由得你
隨便	乜都得	冇搭霎	揦西	是但	求其	由	由得	立亂	閒閒哋	隨得
隨便一點	是是但但
隨便亂放	枳
隨便亂說	是但噏
隨便你	話知你
隨便你…都行	由得你…都得
隨便吧	是但呀
隨便地看	瞄
隨便挑選也不在乎	任揀唔嬲
隨便放	枳
隨便猜	估估吓
隨便發誓	誓願當食生菜
隨便許諾	下扒輕輕	口輕輕
隨便說說	攞嚟講	是但噏	隨便噏	隨口噏
隨便說說罷了	攞嚟講嘅啫
隨便說說而已	攞嚟講嘅啫
隨即	連隨
隨口亂說一氣	隨口噏
隨大流	睇頭	跟大隊
隨大溜	跟大隊
隨意亂說	隨口噏
隨手	跟手
隨手關門	跟手閂門
隨時	分分鐘	周時
隨機分組	河孖
隨機分隊	河孖
隨機應變	執生	馬死落地行
隨遇而安	馬死落地行
隨隨便便	是是但但	求求其其
隱形眼鏡	con
隱形襪	龍船襪
隱私	私隱
隱私權	私隱權
雀斑	曱甴屎	癦屎	黑癦屎
雄貓	貓公
雅緻	骨緻
集中精神	疊埋心水
集市	墟	墟場
集日	墟日
集裝廂車	貨櫃車
集裝箱	貨櫃
集邮票	儲郵票
集郵	儲郵票
雇人	請人
雌	乸
雖說是	話名
雙	啤	孖
雙人床	大床
雙人旁	雙企人	雙徛人
雙層床	碌架床	雙格床
雙層木床	碌架床
雙性人	半男女
雙格床	碌架床
雙生	孖生
雙眼皮	雙眼簷
雙立人兒	雙企人
雙胞胎	孖生仔	孖胎	龍鳳胎
雙胞胎姐妹	孖女
雙胞胎男孩	孖仔
雙腳釘	魚尾釘
雙薪	雙糧
雙辮	孖辮
雙辮子	孖辮
雙陸棋	百家樂棋
雙面刷毛布	fee士	搲毛
雜亂	立雜
雜果潘趣酒	雜果賓治
雜果潘趣飲料	雜果賓治
雜牌	雜嘜
雜牌兒	雜嘜
雜物房	士多房
雜碎	雜
雜貨店	油舖	雜貨舖
雞冠子	雞關
雞尾酒	咯嗲
雞屁股	雞尾
雞排	雞扒
雞毛撣子	雞毛掃
雞爪子	雞腳	鳳爪
雞犬不寧	雞毛鴨血
雞翅膀	雞翼
雞肉包	雞包
雞肉菲力	雞柳
雞肫	雞腎
雞肫子	雞腎
雞胗	雞腎
雞脖子	雞頸
雞腳	鳳爪
雞腿	雞髀
雞菲力	雞柳
雞蛋	雞春
雞蛋糕	雞蛋仔
雞蛋羹	拂水蛋	水蛋
雞蛋餡兒餅	蛋撻
雞蝨	螆	雞螆
雞血	雞紅
雞鴨鵝	三鳥
雞鴨鵝成群旺相	三鳥成群
離不開	唔行得開	離唔開
離了本	出位
離合器	極力子
離婚	拆檔
離得遠	離遠
離職	執包袱	炒老細魷魚
離譜	冇譜
離開	行開	鬆人
離開人世	去咗	走咗
難下嚥	惡鯁	難鯁
難以對付	刁僑扭擰
難以忍受	惡頂	難抵	難頂
難以忍耐	難頂
難以看好	凍過水
難免	少不免
難受	難抵
難吃	惡鯁	難食	難鯁
難商量的	簕竇
難對付	撠手	濕滯
難對付的	惡撠
難得	唔話得
難怪	唔怪之得	唔怪乎	唔怪得	怪之得	怪唔之得	怪唔得
難打交道的	簕竇
難找	難搵
難搞	惡攪
難於支持	難頂
難消化	滯
難為情	難做
難熬	難頂
難相處	惡頂	難相與
難相處的	簕竇
難看	兜踎	岩巉	惡睇	核突	肉酸	難睇	騎呢
難看得要命	難睇到死
難聞的酸臭味	酸宿爛臭
難聽	肉酸
難聽得要命	難聽到死
難聽死了	難聽到死
難聽點說句	大吉利事講句
難處理	惡作	惡做
難說	惡講
難調教	牛精
難走	惡行
難辦	惡作	惡做	惡攪	揦手	撠手	擇使	濕滯	肴頭	踢腳	難攪
難辦的	惡撠
難道	唔通
難道…嗎	唔通…咩
難道這樣還不行嗎	噉都唔得咩
難道這樣都不行嗎	噉都唔得咩
難道還不是	仲唔係
雨傘	遮	雨遮
雨天	雨水天
雨蛙	騎呢𧊅
雨衣	雨褸
雨靴	水鞋
雨鞋	水鞋
雪梨	悉尼
雪白	白雪雪
雪白雪白的	白蒙蒙
雲裡霧裡	一嚿雲
零亂	散收收
零售	散賣
零工	散工
零星	濕星
零活兒	散工
零用	散使
零用錢	散使
零碎	濕濕碎	濕濕碎碎	濕碎
零碎的票子	濕柴
零票	散紙	濕柴
零花	散使
零花兒	散使
零賣	散賣
零鈔	散紙
零錢	散紙	散銀	濕柴	碎紙	碎銀
零零散散	散收收
零零星星	散收收
零零碎碎	濕濕碎碎
零食	口立濕
雷射	鐳射
雹子	雪珠
電吹風	風筒
電器店	電器舖
電子計算機	電腦
電子遊戲廳	打機室	機室	機舖
電子遊樂場	打機室	機室	機舖
電影	影畫戲	戲
電扇	電風扇
電擊喪命	電瓜
電桿	電燈杉
電梯	猎
電梯井	猎槽
電梯口	猎口
電梯門	猎門
電梯門口	猎口
電池	電芯
電源插座	插蘇
電源插頭	插蘇頭
電漿	等離子體
電烙鐵	焫雞
電烤箱	多士爐
電熨斗	電燙斗
電熱水瓶	電水壺	電水煲	電熱水壺
電燈泡	燈膽	電燈膽
電燈總開關	電燈總掣
電腦科學	compute
電話佔線	電話講緊
電話卡	電話咭
電話沒人接	電話冇人聽
電鈕	掣
電鈴	唥鐘
電門鈴	門鐘
電風扇	風扇
電飯鍋	電飯煲
需要	使
震	扽
震動	扽
霉乾菜	梅菜
霎時間	霎時
霧氣	霞氣	霧
霧霾	煙霞
露出	打出
露出小腿	打出腳骨
露出水面	蒲頭
露出胳膊	打出手骨
露出胸脯	打出心口
露出膝蓋	打出膝頭哥
露天空地	天井
露宿街頭	瞓街	踎街
露水	霧水
露臉	攞彩
露面	出鏡	蒲	蒲面	蒲頭
露餡	漏底
露餡兒	爆煲	穿煲
露餡餅	撻
露骨	出面
霸佔	霸
霸道	霸掗
霾	煙霞
靈巧古怪	鬼馬
靈敏	醒水
青一塊紫一塊	瘀	瘀咗
青年女子	後生女
青年男女	後生仔女
青年男子	後生仔
青春痘	暗瘡
青果	山欖	生欖	白欖
青椒	燈籠椒
青花菜	西蘭花
青葡萄	青提子
青蛙	田雞	蛤乸	蛤𧊅
青衣寒鯛	青衣	青衣魚
靜一靜	靜吓
靜悄悄	靜英英
靜靜地	靜英英	靜雞雞
非…不可	想唔…都幾難
非同小可	嘢少	𠹳
非同小可的事情	𠹳嘢
非常	勁	十分之	好鬼死	極之	死咁	認真	超	非常之	飛起	鬼死
非常…	…到極	…到死	…到飛起	鬼咁…	鬼死咁…
非常兇狠的樣子	生人勿近
非常吝嗇	孤寒到死
非常失望	透心涼
非常好	冇得彈	好到冇朋友	好正
非常好看	好睇過睇戲
非常容易	一字咁淺	容乜易	話咁易
非常忙亂	七個一皮
非常忙碌	忙到死	踢晒腳
非常愚蠢	蠢到加零一
非常慢	蟻躝噉
非常憤怒	火遮眼
非常昂貴	揦脷
非常濃	𠹳凸凸	𠹳撻撻
非常熟識	熟口面
非常熱	熱到飛起
非常狼狽	咧晒氣
非常生氣	好嬲	嬲到震
非常疼愛	錫晒
非常瘦	瘦到飛起	瘦蜢蜢
非常的標緻	弗到漏油
非常皺	巢咪𠵼
非常矮	矮凸凸
非常稠	𠹳凸凸	𠹳撻撻
非常糊塗	懵上心口	懵到上心口
非常肯定	的而且確
非常舒心	掂過條蔗
非常苦	苦刁刁
非常要好的人	孖公仔
非常貴	貴到飛起
非常辛苦	苦過弟弟
非常迅速	話咁快
非常重要	非常之重要
非常開心	開心到飛起
非常霉爛	霉渧渧
非常順利	掂過條蔗	順風順水
非常頑皮	曳到死
非常高	爆燈
非法入境者	人蛇
非法勞工	黑工
非法移民	人蛇
靠上去	埋去
靠不住	兒嬉	冇腰骨	化學	靠唔住
靠前來	埋嚟
靠前去	埋去
靠山	倚憑	手骨	把炮
靠岸	埋岸
靠攏	埋
靠牆的座位	卡位
靠白薯過活	捱番薯
靠背	拼
靠裡邊	對埋
靠裡邊的	對埋
靠裡頭	埋便
靠近	埋	埋身	挨近	近住
靠過來	埋嚟
靠邊站	企埋邊
面	便	埲
面子	非士	面	飛士
面孔	口面
面孔白淨	青靚白淨
面容	口面
面巾紙	tissue	紙巾
面熟	熟口熟面	熟口面	熟面口	面口熟	面善
面生	生暴
面紅耳赤	面紅面綠
面紙	tissue	紙巾
面色	口面
面色青白	面青	面青青
面試	見工
面談	面試
面貌	口面
面部美容	飛數
靦著胸脯挺著肚子	躽胸凸肚
靴子	靴
鞋墊	鞋薦
鞋子	鞋
鞋帶鬆了	甩咗鞋帶	甩鞋帶
鞋店	鞋舖
鞋後跟	鞋踭
鞋拔子	鞋抽
鞋跟	鞋踭
鞦韆	千秋	韆鞦
鞭子	鞭
鞭打	[拂]
鞭炮	炮仗
韌	煙韌
韓國	南韓
音樂專輯	唱碟
響	唥
頂	堂
頂什麼用	把鬼
頂住門	𢷮住度門
頂個屁用	把屁
頂呱呱	冇得頂
頂呱呱的	勁
頂嘴	頂頸	駁嘴	駁嘴駁舌
頂多	至多	頂籠
頂多也不过	至多
頂多是	至多
頂多是…	至多唔係
頂替	頂檔
頂替一下	頂住檔
頂用	使得	殺食
項鏈	頸鏈
順便	趁手
順便提一下	話時話
順便說說	話時話
順利	就手	順攤	順檔
順勢而為	借力打力
順口	口爽
順口溜	白欖
順手	趁手	跟手
順水推舟	順風駛𢃇
順當	順攤	順檔
順眼	合眼緣
順耳	啱聽
順著拉	趟
順著推	趟
順路	啱路	掂路
順路車	順風車
順順當當	順順攤攤
預付定金	落定
預先	預早
預售屋	樓花
預售房屋	賣樓花
預定位置	book位
預定座位	book位
預料到	睇白
預訂	book
預訂房間	訂房
預計	打	打預	預
預計在內	打埋
預購房屋	買樓花
預配	set
預配好	set好
頑皮	冇王管	反斗	奀皮	扭計	曳	百厭	貔貅	跳皮	韌皮
頓	輪
領導	亞頭	頭
領導層	高層
領導者	亞頭	頭
領帶	領𧘹	𧘹
領悟暗示	醒神
領獎	攞獎
領班	科文
領結	煲呔	煲𧘹
領錢	攞錢
領頭	擔大旗
頭	一哥	亞一	頭殼
頭一次	頭威頭勢
頭上長疥瘡	瘌痢頭
頭上長頭癬	瘌痢頭
頭兒	事頭	亞一	話事人	頭
頭垢	頭泥
頭屑	頭皮	頭皮碎
頭昏腦脹	頭大
頭暈暈	暈舵舵
頭暈眼花	七彩
頭朝下	打倒掟
頭款	首期
頭疼	頭赤
頭疼腦熱	頭暈身㷫	頭暈身熱
頭痛	頭赤
頭癬	瘌痢
頭皮屑	頭皮	頭皮碎
頭目	亞頭	大佬	頭
頭破血流	損手爛腳
頭腦不清	矇查查
頭腦清醒	心水清
頭銜	銜頭
頭頭	頭
頭頭兒	亞頭
頭頭是道	有紋有路
頭髮卡子	頭夾	頭箍
頭髮夾子	頂夾	髮夾
顆	粒
顆粒兒大	大粒
顆粒兒小	細粒	細細粒
顏色	色水
願不願意	制唔制
願意	制	肯制
顛	扽
顛簸	扽	扽扽吓
類神經網路	人工神經網絡
顧客	客仔
顧家	傍家
顫動	䟴	趲	震
顫抖	打冷震	揗
顯威風	威水
顯擺	拋書包
顯眼	sharp	搶眼	覺眼
顯示器	螢幕
顯示威風	也文也武
顯示實力	曬馬
顯貴	大粒
顯顯本事	騷quali
顯顯本領	騷quali
顽梗不化	死牛一便頸
風帆衝浪	滑浪風帆
風帽	雪帽
風格低	低波
風水師	風水生
風派	斑馬佬
風浪板	滑浪風帆
風涼話	唱口
風箏	紙鷂
風衣	風褸
風雨橫掃	橫風橫雨
風雨衣	乾濕褸
風雪帽	雪帽
風馬牛不相及	牛頭唔搭馬嘴
風馬牛不相干	牛頭唔搭馬嘴
颳大風	打風
颳風	打風
颳風下雨	翻風落雨
颳颱風	打風
飄飄然	鬆毛鬆翼
飛機師	機師
飛盤	飛碟
飛蛾	蛾
飛行員	機師	飛機師
食古不化	唔化
食堂	飯堂	飯廳
食托菜薊	雅枝竹
食指	二指
食物	嘢食
食量大	大食
飯勺	飯殼
飯店	酒店
飯桌	餐枱
飯桶	一嚿飯	大食
飯桶一個	一嚿飯
飯碗	水	碗
飯莊	酒家	酒樓
飯菜	飯餸	餸菜
飯鍋	飯煲
飯鍋的蓋	飯蓋
飲料	飲品
飲用水	食水
飽到要爆炸	飽死我啦！
飽吃一頓	飽擦一輪
飾邊	厘士
餅乾	餅仔
餅券	餅咭
餅店	餅舖
餅模子	餅印
養大	湊大
養小老婆	包二奶
養成…的習慣	整成…嘅習慣
養牲口	養畜牲
養老院	安老院
養肥	槽
養膘	槽
養足精神	唞足精神
餐具墊	枱薦	餐薦
餐巾紙	tissue	紙巾
餐廳	酒家	酒樓
餐桌	食飯枱	飯枱	餐枱
餐館	食肆
餓	肚餓
餓肚子	紮炮
餓過了頭	餓過飢
餓過勁兒	餓過飢
餘數	尾數
餘燼	火屎
餛飩	雲吞
餛飩麵	雲吞麵
餡兒	料
餡兒餅	撻
餡餅	批
餵豬	餼豬
餵雞	餼雞
餵養	餼
餿	宿	有味
餿主意	屎坑橋	屎坑計	屎橋	屎計
餿了呱唧	宿哼哼
餿味	宿
餿臭	宿哼哼
餿點子	屎橋
饊子	蛋饊
饒舌	口多多
饒舌婦	八卦婆	八婆
饞	為食
饞鬼	為食貓	為食鬼
饮用巧克力	熱朱古力
首付	首期
首席信息官	資訊總監
首席執行官	行政總裁
首席技術官	技術總監
首席財務官	財務總監
首次	頭威頭勢
首班車	頭車
首肯	肯制
首領	亞頭
香子蘭	雲呢拿	雲呢拿草
香油	蔴油
香波	洗頭水
香港	香港地
香港人	港人	港燦
香港小姐	港姐
香港新華分社	新記
香港漫畫	港漫
香港的	鹹水
香港總督	港督
香港這個地方	香港地
香煙	煙	煙仔
香煙攤兒	煙仔檔
香燭用品	紙紮祭品
香燭用品店	紙紮舖
香燭紙馬	元寶蠟燭	元寶蠟燭香
香皂	香梘
香腸	燒腸	腸仔	臘腸
香腸卷	腸仔卷
香芹	洋芫茜	番芫茜
香草	雲呢拿	雲呢拿草
香草冰淇淋	雲呢拿雪糕
香草味	雲呢拿
香草牛奶冰淇淋	香草奶昔
香菇	冬菇
香菜	芫茜
香蕉	蕉
香蕉人	竹升
香蕉牛奶冰淇淋	香蕉奶昔
香蕉皮	蕉皮
香香的	香噴噴
馬上	即	即刻
馬上來	即嚟
馬上看	即睇
馬來西亞	大馬
馬大哈	大頭蝦	論盡
馬屁精	擦鞋仔
馬桶	塔	屎塔	座廁
馬桶蓋子	屎塔蓋
馬競	馬體會
馬自達	萬事得
馬虎	冇搭霎	大懵	揦西
馬蜂	黃蜂
馬蜂窩	黃蜂竇
馬賽克	瓦仔	紙皮石	階磚仔
馬賽克方塊石	瓦仔	紙皮石	階磚仔
馬路上十分堵車	塞晒車
馬路邊	街邊
馬達	摩打
馬鈴薯	荷蘭薯	薯	薯仔
馬鈴薯泥	薯蓉
馬鈴薯片	薯片
馬馬虎虎	不過不失	揦揦西西	揦西	求求其其	麻麻	麻麻哋
馬駒子	馬仔
馴良	馴品
駕照	車牌
駕船	駛𢃇
駕證	車牌
駕車	揸車
駕駛	揸
駕駛執照	車牌
駕駛汽車	揸車
駕駛盤	軚盤
駕駛證	車牌
駕駛車輛	揸車
駝子	亞駝
駝背者	亞駝
駭客	黑客
騎在肩膀上	騎膊馬
騎摩托車	揸電單車
騎腳踏車	跴單車	踩單車
騎自行車	跴單車	踩單車
騎驢找馬	騎牛搵馬
騎（自行車等）	跴
騙	呃	撻	棍
騙不了	呃唔到
騙不了人	呃唔到人
騙人	出術	出貓	出貓仔	出貓招	呃人	呃鬼	呃鬼食豆腐	搵丁	搵人笨	搵人老襯	搵笨	搵老襯	放貴利	棍人	滾人	超技術
騙人上當	嗿人入局
騙人說出真相	嗿人爆料
騙吃	呃食
騙吃騙喝	呃飲呃食
騙子	光棍	撞棍	棍友	滾友	神棍	老千
騙斤兩	呃秤
騙誰	呃鬼
騙財	掠水
騙賣勞力	賣豬仔
騙錢	呃錢	掠水	撻錢	棍錢	滾錢
騙錢財	撻
騷包	姣妹
騷貨	姣妹	姣婆	肉彈
騾子	騾
驅趕	趯
驅逐	趯
驕傲	大資爺	沙塵	牙擦
驕傲自大	咁串	沙塵白霍	讕醒
驕傲自滿	頭𩓥𩓥
驕橫放肆	也文也武
驗票口	閘
驚恐	發驚青	驚青	驚青青	驚驚青青
驚恐萬分	發驚青	驚青青	驚驚青青
驚慌	慌晒	發驚青	驚青	驚青青	驚驚青青
驚慌失措	手揗腳震	發驚青	驚青青	驚驚青青
驚跳	扎
驚醒	扎醒	醒瞓
驟雨	白撞雨
驢子	驢
驢脣不對馬嘴	牛頭唔搭馬嘴
骨氣	腰骨
骨灰	靈灰
骨瘦如柴	瘦骨賴柴
骨瘦如柴的人	瘦骨如柴煲碌竹
骨關節	骹
骨頭	骨
骯髒	揦鮓	污糟	邋遢
骯髒的東西	污糟嘢
骰子	色	色仔
髒	揦鮓	污糟	邋遢
髒兮兮的	污糟邋遢
髒衣服	污糟衫
髒話	爛口	粗口
髒貌	油湆湆
髒錢	污糟錢
髒髒的	污糟邋遢
體弱多病	孱
體恤	T恤	笠記	過頭笠
體恤衫	T恤	笠記	過頭笠
體溫表	探熱針
體溫計	探熱針
體溫高	身㷫
體質衰弱	孱
體面	企理	好好睇睇	威水	架勢
高中	高中學校	高中書院
高人一等	大晒
高低不平	岩岩巉巉	岩巉	巖巉	巖巖巉巉
高個子	高佬
高傲	高竇
高傲的人	高竇貓
高利貸	貴利
高壓鍋	高速煲
高大	牛高馬大
高大健壯	大隻騾騾
高大威武	高大威猛
高大英俊	高大威猛
高官	大粒癦
高層領導	高層
高工資	高人工
高強	使得
高架人行道	行人天橋
高架路	天橋
高湯	上湯
高爾夫	哥爾夫
高爾夫球	哥爾夫球
高空彈跳	笨豬跳
高粱	高粱粟
高級中學	高中學校	高中書院
高級人員	高層
高級轎車	靚車
高興	high	合皮	歡喜
高薪	高人工
高薪水	高人工
高跟鞋	高踭鞋
高麗菜	椰菜
髮刷	梳
髮卡	頭夾	頭箍
髮夾	頭夾
髮尖	髮尾
髮梢	髮尾
髮箍	頭箍
髮蠟	頭蠟
髮邊	頭髮腳	髮腳
髮際	頭髮腳	髮腳
鬆動	走趲
鬆口氣	唞啖氣
鬆弛	削
鬆散	散收收
鬆氣	唞氣
鬆軟	削	腍	鬆化
鬆鬆垮垮的	鬆匹匹
鬆鬆散散	散收收
鬆鬆散散的	鬆匹匹
鬆鬆散散的樣子	散散收收
鬈髮	攣毛
鬍子	鬍鬚	鬚
鬍子拉碴的	鬍鬚勒特
鬍子鯰	塘蝨
鬥不過他	唔夠佢鬥
鬥不過你	唔夠你鬥
鬥個你死我活	鬥到七彩
鬥彆扭	鬥氣	鬥負氣
鬥氣	拗氣
鬥蟋蟀	鬥蟀
鬥酒	劈酒
鬥魚	花手巾
鬧	反	囉囉攣	囉攣
鬧事	攪事
鬧個不停	嘈嘈閉
鬧個沒完	嘈嘈閉	攪攪震
鬧別扭	霎氣
鬧區	旺區
鬧哄哄	嘈喧巴閉
鬧大了	玩大咗
鬧彆扭	扭計
鬧感冒	作感冒
鬧水災	水浸
鬧病	作病
鬧翻	擘面
鬧著玩	柴娃娃	詐假意
鬧著玩兒	玩吓啫	貪得意
鬧著玩玩	玩吓啫
鬧著玩而已	玩吓啫
鬧鐘	唥鐘
鬧騰	囉囉攣
鬱悶	心悒
鬼主意	屎計	貓招
鬼叫	衣衣哎哎
鬼故事	鬼故
鬼混	伊挹	胡混
鬼祟	閃縮	鬼鼠
鬼迷心竅	鬼揞眼
鬼頭蛤蟆眼	蛇頭鼠眼	蛇頭鼠腦
鬼鬼祟祟	閃閃縮縮	鬼鬼鼠鼠
鬼魂纏身	鬼上身
鬼點子	橫丫腸	貓招
鬼點子多	鬼馬
魁偉	高大威猛
魁梧	高大威猛
魂飛魄散	失魂
魔方	扭計骰
魔法	茅山	茅山法術	茅山術
魔術方塊	扭計骰
魚丸	魚蛋
魚丸粉麵	魚蛋河
魚刺	魚骨
魚卵	魚春
魚塘的基堤	塘壆
魚塘邊的基堤	魚塘壆
魚子	魚春
魚店	魚檔
魚排	魚扒
魚片兒	魚片
魚片粥	魚生粥
魚產卵	散春
魚肉	魚柳
魚肉丸子	魚丸	魚蛋
魚肉丸子湯麵	魚蛋麵
魚肉糜	魚蓉
魚肚子肉	魚腩
魚腹部的肉	魚腩
魚菲力	魚柳
魯莽	擒青
鮭魚	三文魚
鮮	鮮甜
鮮明	sharp
鮮活的海鮮	生猛海鮮
鮮美	鮮甜
鮮艷	sharp	威水
鮮花	生花
鮮蝦卷粉	鮮蝦腸粉
鯰	塘蝨
鯰魚	塘蝨
鰻魚	鱔
鱒魚	大眼雞
鱷梨	牛油果
鱸滑石斑魚	龍躉
鳥	雀	雀仔
鳥兒	雀仔
鳥屋	雀屋
鳥巢	雀仔竇
鳥窩	雀仔竇	雀竇
鳥舍	雀屋
鳥食	雀粟
鳳梨	菠蘿
鳴聲	唱口
鳴鐘	響鐘
鴇母	龜婆
鴨子	鴨
鴨梨	雪梨
鴨舌帽	喼帽	波帽	鴨咀帽
鴨蛋	鴨春
鴿子	白鴿	鴿
鵜鶘	塘鵝
鵝卵石	石春	鵝春石
鵝蛋臉	瓜子口面	瓜子面
鹹得難受	揦脷
鹹酸菜	鹹菜
鹹鴨蛋	鹹蛋
鹹鹹的	鹹鹹哋
鹹黃花魚	黃花筒鹹魚
鹼	鹼基	鹽基
麂子	黃猄
麥克風	咪	咪高峰
麥片	麥皮
麵包師傅	餅師
麵包店	麵包舖
麵包車	van仔	小巴
麵包車司機	小巴司機
麵店	麵檔
麵糊	粉
麻	痺
麻利	快手
麻團	煎堆
麻子	豆皮	豆皮佬
麻將	麻雀
麻木	木獨	痺
麻煩	大鑊	擇使	甩質	茶煲	論盡	費事	阻滯	頭大
麻煩了	呢次弊	弊喇
麻煩事	林沈嘢	茶煲	蘇州屎
麻煩你	唔該
麻煩大	大劑
麻煩大了	乃大鑊	乃鑊	大鑊
麻煩的	林沈
麻煩著呢	麻鬼煩
麻痺	痺
麻臉	豆皮
麻袋	麻包袋
麻雀	麻甩
黃包車	車仔
黃土	黃泥
黃昏	諵光黑
黃書	鹹書
黃瓜	青瓜
黃瓜旺季	黃瓜造
黃瓜的蒂	青瓜椗
黃瓜蒂	青瓜椗
黃線	紅衫	紅衫魚
黃臉婆	黃面婆
黃色的	不文	鹹
黃色電影	鹹濕電影
黃芪	北芪
黃花菜	金針	金針菜
黃花魚	黃花筒
黃蠟	蜜蠟
黃醬	麵豉
黃金放映期	黃金檔期
黏	[湆]	黐
黏乎乎	湆湆令	黐湆湆	黐黐湆湆
黏乎乎的	湆黐黐
黏人	黐身
黏得厲害	湆湆令	黐湆湆	黐黐湆湆
黏液	潺
黏液很多	好多潺
黏牙	黐牙
黏糊	[湆]	湆懦
黏糊糊	[湆]	湆湆令	黐湆湆	黐黐湆湆
黏糊糊的	湆黐黐
黏糖	戀糖
黏郵票	黐郵票
黏黏的	湆湆令	湆黐黐	肥湆	黐湆湆	黐立立	黐黐湆湆
黏黏糊糊	唔嗲唔吊	湆湆令	黐湆湆	黐黐湆湆
黏黏糊糊的	[湆]	湆黐黐
黑不溜秋	黑古勒掘	黑古勒特
黑加侖	黑加侖子
黑咕隆冬	黑孖孖
黑咕隆咚	黑擝擝
黑咖啡	黑啡	齋啡
黑咪麻	黑孖孖
黑夜	夜麻麻
黑幫頭目	江湖大佬
黑斑豬齒魚	青衣	青衣魚
黑桃	葵扇
黑洞洞的	黑孖孖
黑漆漆	黑孖孖	黑擝擝
黑燈瞎火	烏燈黑火
黑痣	癦
黑社會份子	蠱惑仔
黑社會大哥	江湖大佬
黑社會頭目	江湖大佬
黑線軸兒	黑線轆
黑莓	黑啤梨
黑著臉	口黑面黑	揦口揦面	揦埋口面	燶起塊面	苦瓜乾噉口面	苦瓜噉口面	苦瓜噉嘅面	苦瓜噉面	苦瓜面	黑口黑面
黑葡萄	黑提子
黑豆果	黑加侖子
黑起臉來	燶起塊面
黑醋栗	黑加侖子
黑魚	生魚
黑黑的	黑古勒掘	黑古勒特	黑擝擝
點	定點	層
點了火	撻著
點名	嗌名
點子	橋
點擊	click
點火	撻	撻車
點球	十二碼
點穴	點脈
點菜	叫餸
點菜吃飯	叫餸食飯
點補點補	頂吓肚
點進去	click入去
點頭	岌頭
點頭點腦	岌頭岌髻
黿	水魚
鼈	水魚
鼓掌	拍手掌
鼓掌歡迎	拍手掌歡迎
鼓起腮幫子	掬起泡腮	鼓埋泡腮
鼠標	mouse	滑鼠
鼻塞	盟晒	盟鼻
鼻子	鼻	鼻哥
鼻孔	鼻哥窿
鼻涕	鼻水
鼻青臉腫	口腫面腫
齁苦	鹹赧赧
齁鹹	鹹赧赧
齊	夠數
齊全	頂籠
齊墩果	烏欖
齒輪齒條嚙合式升降機	籠猎
齒齦	牙肉
齙牙	哨牙
齜牙	哨牙
龍潭虎穴	老虎蟹
龍眼肉	圓肉
龍舟	龍船
龍舟比賽	鬥龍船
龍鍾	論盡
龍鳳鐲	龍鳳鈪
龐克	崩仔
龜兒子	龜蛋
龜孫子	契弟
