當	当
計	计
長	长
傑	杰
還	还
頭	头
份	份	分
來	来
係	系
個	个
國	国
醜	丑
對	对
鐘	钟
餅	饼
噉	啖	噉
億	亿
復	复
錢	钱
動	动
靜	静
價	价
煙	烟
講	讲
雲	云
飯	饭	飯
團	团
場	场
歡	欢
間	间
風	风
關	关
淺	浅
馬	马
職	职
會	会
細	细
將	将
萬	万
時	时	记
順	顺
級	级
兩	两
張	张
腳	脚
擔	担
於	于	於
樣	样
書	书
鮮	鲜
糞	粪
黃	黄
條	条
數	数
氣	气
樂	乐
樓	楼
鳳	凤
養	养
檔	档
過	过
傷	伤
殼	壳
淚	泪
決	决
勝	胜
負	负
瀉	泻
里	里	厘
蝨	虱
疋	匹	疋
龍	龙
門	门
發	发
盤	盘	盤
眾	众
齋	斋
磚	砖
筆	笔
雙	双
夾	夹	夾
統	统
經	经
脈	脉
傳	传
舉	举
舊	旧
處	处
見	见
鍾	钟	锺
覽	览
驚	惊
夢	梦
債	债
蟻	蚁
鬆	松
輪	轮
轆	辘
邊	边
鑊	镬
陣	阵
隻	只
雞	鸡
鳴	鸣
項	项
頸	颈
額	额
飛	飞
沖	冲
髮	发
鈞	钧
點	点
齊	齐
遊	游	遊
亂	乱
慾	欲
縱	纵
離	离
號	号
詩	诗
窮	穷
絕	绝
絃	弦	絃
顛	颠
Ｔ	T	Ｔ
識	识
勢	势
婦	妇
節	节
顏	颜
紅	红
蓮	莲
釘	钉
幾	几
撥	拨
棟	栋
館	馆
歲	岁
線	线
維	维
電	电
緘	缄
櫈	凳
鐵	铁
華	华
測	测
帶	带
鳥	鸟
禮	礼
無	无
終	终
達	达
晝	昼
機	机
灘	滩
湯	汤
畫	画
組	组
織	织
裝	装
窰	窑
貨	货
網	网	纲
聯	联	聯
腦	脑
臺	台
蠟	蜡
車	车
鋪	铺
鏈	链
顎	颚
農	农
輕	轻
懷	怀
欄	栏
環	环
賤	贱
評	评
僅	仅
聲	声
厭	厌
詳	详
議	议
像	象	像
單	单	單
駕	驾
駛	驶
惡	恶
問	问
題	题
捨	舍
摟	搂
曉	晓
濟	济
為	为
話	话
後	后
謂	谓
覺	觉
緊	紧
孫	孙
說	说
憑	凭
績	绩
姪	侄
態	态
歷	历
盃	杯
語	语
遺	遗
產	产
銀	银
紀	纪
戰	战
貿	贸
丟	丢
媽	妈
並	并
層	层
總	总	總
記	记
黨	党
員	员
務	务
圖	图
陸	陆
學	学
絡	络
審	审
師	师
內	内	內
廣	广
碼	码
別	别	別
區	区
褸	褛
資	资
際	际
醫	医
藥	药	藥
廈	厦
頻	频
牆	墙
軍	军
權	权
帥	帅
義	义
標	标
謀	谋
辦	办
園	园
餘	余	馀
揚	扬
陳	陈
鈴	铃	鈴
豬	猪	豬
東	东
滯	滞
誰	谁
歸	归
連	连
宮	宫
輸	输
彎	弯
魚	鱼
針	针
島	岛
灣	湾	灣
兒	儿
靈	灵
與	与
鴿	鸽
齒	齿
乾	干	乾
凈	净
淨	净	淨
濕	湿	濕
燒	烧
麵	面
爭	争
瑤	瑶	瑤
柱	柱	椎
骾	鲠	骾
鯁	鲠
揈	轰	揈
籠	笼
崗	岗
諗	谂
勞	劳	勞
實	实
幹	干
進	进
幫	帮
協	协
變	变
櫃	柜
稜	棱
鏡	镜
舖	铺	舖
屍	尸
鹽	盐
亞	亚
嬸	婶
運	运
視	视
爺	爷
貓	猫
駝	驼	駝
費	费
換	换
輝	辉
課	课
擠	挤
燈	灯
響	响
倫	伦
壽	寿
緣	缘
紙	纸
輩	辈
滿	满
觀	观
盡	尽
憤	愤
羣	羣	群
彈	弹
衞	卫	衞
湧	涌
獸	兽
敵	敌
轉	转
殺	杀
勻	匀
屆	届
紹	绍
們	们
仝	同
難	难
嬡	嫒
應	应
衝	冲
報	报
則	则
遠	远
劍	剑
賢	贤
業	业
領	领
撈	捞
蘭	兰
麪	面	麪
閑	闲
墳	坟
佈	布
設	设
褲	裤
結	结
賀	贺
縣	县
佔	占
儀	仪
掛	挂
韻	韵
鴻	鸿
槍	枪
廟	庙
誕	诞
斃	毙
狀	状
詞	词
賊	贼
虛	虚
賽	赛
嘅	嘅	慨
嗎	吗
佢	佢	渠
稱	称
併	并
橫	横	橫
冊	册
銅	铜
規	规
據	据	據
槓	杠
鋼	钢
鬱	郁
頓	顿
蝕	蚀	食
咪	咪	眯
喎	㖞
羅	罗
虜	虏
期	期	朞
溫	温
薦	荐
證	证
護	护
險	险	險
橋	桥
補	补
訂	订	定
倉	仓
頡	颉
衛	卫
囉	罗	啰
體	体
籮	箩
竈	灶
強	强	強
篤	笃
倖	幸
賣	卖
聾	聋
鑑	鉴
開	开	開
屬	属	𡳞
偉	伟
戲	戏
慣	惯
懶	懒
襯	衬
莊	庄
騷	骚
龜	龟
誌	志
錄	录
偪	逼
側	侧
擊	击
偵	侦
騙	骗
穎	颖
傖	伧
傘	伞
帳	帐
傢	家	傢
雜	杂
𠌥	𠆿
妝	妆
穀	谷	穀
傭	佣
寶	宝
説	说	説
遞	递	遞
傴	伛
僂	偻
戇	戆
傾	倾
閒	闲	间	閒
僑	侨
匯	汇
僕	仆
從	从
僱	雇
儉	俭
樸	朴
儕	侪
嘩	哗
優	优
儲	储	儲
備	备
郵	邮
儼	俨
燭	烛
邨	村	邨
貝	贝
闊	阔
饑	饥
兇	凶
頂	顶
暈	晕
脫	脱	脫
譜	谱
陰	阴
稅	税	稅
廠	厂
讀	读
閘	闸
闈	闱
摳	抠
極	极
粵	粤
嶺	岭
聞	闻
週	周	週
廁	厕
認	认
調	调
隊	队
準	准
揀	拣
載	载
颯	飒
癮	瘾
爛	烂
紋	纹
膽	胆
類	类
著	着	著
盞	盏
趲	趱
釐	厘	釐
錯	错
烏	乌
蠅	蝇
現	现
試	试
剷	铲
貴	贵
鏟	铲
竇	窦
蓆	席
賭	赌
厲	厉
薩	萨
鈔	钞
麥	麦
卻	却
執	执
熱	热
庫	库
親	亲
凍	冻
檸	柠
滾	滚
凜	凛
凱	凯
廳	厅
廚	厨
沒	没
爾	尔
痲	麻	痲
糧	粮
蠱	蛊
術	术
獻	献
銃	铳
鋸	锯
樹	树
擰	拧
喬	乔
蠻	蛮
構	构
訓	训
絲	丝
戀	恋
斷	断
誘	诱
刪	删
簡	简
癢	痒
鬚	须
繼	继
廢	废
塵	尘
座	座	坐
驅	驱
剎	刹
剛	刚
剝	剥
愛	爱
創	创
劃	划	画
劄	劄	札
劇	剧
斬	斩
劉	刘
荊	荆
錫	锡
俠	侠
鶴	鹤
侖	仑
幣	币
種	种
奮	奋
鬥	斗
効	效
勁	劲
悶	闷
懼	惧
須	须
勛	勋
敗	败
擋	挡
範	范
圍	围
獎	奖
勵	励
勸	劝
諭	谕
粧	粧	妆
驗	验
鴟	鸱
鴨	鸭
奧	奥
萊	莱
納	纳
謬	谬
么	幺	么
壺	壶
蓋	盖
漢	汉
藝	艺
臘	腊
鋤	锄
鎬	镐
嬌	娇
鵝	鹅
錘	锤
煉	炼
冪	幂
両	两	両
鹹	咸	鹹
悅	悦
聳	耸
聽	听
責	责
疊	叠
襪	袜
訴	诉
厠	厕
偽	伪
飲	饮
參	参	叁
閲	阅	閲
靚	靓
腸	肠
誼	谊
覆	复	覆
縮	缩
財	财
災	灾
溝	沟
軟	软
罰	罚
叢	丛
啞	哑
擘	掰	擘
腫	肿
興	兴
爐	炉
擾	扰
謝	谢
喚	唤
罵	骂
囑	嘱
惱	恼
吒	咤	吒
跡	迹
裡	里
適	适	適
顯	显
邏	逻
輯	辑
銷	销
圓	圆
專	专
臨	临
撚	捻	撚
噴	喷
飴	饴
吳	吴
彥	彦
吶	呐
脹	胀
膠	胶	膠
漲	涨
皺	皱
呂	吕
鈍	钝
辭	辞
絨	绒
駁	驳
蜆	蚬
呵	呵	啊
搶	抢
籲	吁
隨	随
藹	蔼
諧	谐
醬	酱
錶	表
豐	丰
嚐	尝
哅	讻
喲	哟
擺	摆
寧	宁
詠	咏
該	该
阿	阿	啊
擬	拟
擇	择
蕎	荞
夠	够	夠
攝	摄
憂	忧
寫	写
製	制
論	论
顧	顾
涼	凉	涼
辯	辩
騎	骑
唸	念	唸
尋	寻
紐	纽
嘸	呒
嚨	咙
椗	碇
欖	榄
鉗	钳
貢	贡
慶	庆	慶
喪	丧
喫	吃
獨	独
簷	檐
徑	径
軌	轨
嘆	叹
閉	闭
曬	晒
嘍	喽
嘔	呕
嘖	啧
嘗	尝
撻	挞
壞	坏
噓	嘘
嘮	唠
嘰	叽
嚕	噜
脣	唇
諄	谆
噚	㖊
嚇	吓
澀	涩
嚴	严
囂	嚣
攣	挛
塊	块
緙	缂
辮	辫
穩	稳
蕩	荡
鄉	乡
減	减
預	预
殤	殇
營	营
約	约
繞	绕
謊	谎
軲	轱
積	积
顱	颅
魷	鱿
莖	茎
峽	峡
廬	庐
氈	毡
質	质
蟲	虫
漁	渔
監	监
釣	钓
訊	讯	訊
闕	阙
棧	栈
攤	摊
籌	筹
贏	赢
慘	惨
蝦	虾
礎	础
堅	坚
壘	垒
堯	尧
販	贩
塗	涂
塹	堑
墊	垫
墜	坠
墮	堕
墾	垦
壓	压
軸	轴
習	习
壟	垄
壯	壮	壯
麗	丽	利
壼	壸
輔	辅
陽	阳
洩	泄
煩	烦
賈	贾
麼	么	麽
盜	盗
裏	里
够	夠
薑	姜	薑
夥	伙	夥
劑	剂
掃	扫
獲	获
廝	厮
瀝	沥
牀	床	牀
癲	癫
慳	悭
窩	窝
纜	缆
絞	绞
艙	舱
灑	洒
荳	豆
蔴	蔴	麻
蠔	蚝
貪	贪
騾	骡
紛	纷
鱷	鳄
鴉	鸦
驕	骄
壇	坛
願	愿
談	谈
誅	诛
滅	灭
麩	麸
曆	历
輻	辐
穠	秾
憶	忆
諸	诸
階	阶
嫋	袅
蹟	迹
奪	夺
賴	赖
搵	揾
許	许
償	偿
訣	诀
頤	颐
齡	龄
礙	碍
蘇	苏
藍	蓝
婭	娅
脅	胁
娛	娱
閣	阁
綠	绿
葉	叶
璣	玑
鎖	锁
遷	迁
鐸	铎
擲	掷
孿	孪
檢	检
畢	毕
導	导
潤	润
訪	访
鑼	锣
恥	耻
寢	寝
鑿	凿
給	给
寬	宽
寵	宠
暉	晖
覓	觅
厴	厣
轎	轿
鋭	锐	鋭
禡	祃
崙	仑
瀨	濑
屢	屡
貼	贴
峯	峯	峰
鬍	胡
岡	冈
巒	峦
峇	巴	峇
鷹	鹰
崢	峥
嶸	嵘
潰	溃
嶄	崭
巋	岿
巖	岩
搖	摇
撓	挠
餉	饷
幗	帼
諾	诺
呎	尺	呎
鑒	鉴
竅	窍
爲	为
棄	弃
撐	撑
龐	庞
築	筑
弔	吊
軒	轩
彌	弥
彫	彫	雕
徵	征	徵
詢	询
購	购
徹	彻
療	疗
腎	肾
甦	苏
臟	脏
恆	恒
籬	篱
惻	恻
悽	凄
緒	绪
聖	圣
霧	雾
闌	阑
撫	抚
歎	叹
慚	惭
慮	虑
憫	悯
憲	宪
懇	恳
摯	挚
懲	惩
懸	悬
鳩	鸠
戶	户
掙	挣
鐐	镣
纈	缬
缽	钵
鉢	鉢	钵
鉸	铰
賞	赏
躉	趸
韆	千
鞦	秋
扠	扠	叉
虧	亏
盪	荡
續	续
讓	让
瀟	潇
買	买
檯	台
簽	签
紗	纱
鍊	炼
拋	抛
諫	谏
飾	饰
徠	徕
禿	秃
蘆	芦
選	选
瘡	疮
挾	挟	夹
捱	挨	捱
餓	饿
捲	卷
闥	闼
異	异
掗	挜
採	采
擷	撷
觸	触
託	托	讬
昇	升
鮓	鲊
揮	挥
揹	背
㨘	擤
損	损
撳	揿
憐	怜
搗	捣
摋	𢫬
摑	掴
編	编	編
摺	折	摺
攪	搅
撉	蹾
闆	板
撟	挢
墻	墙
撲	扑	撲
鷓	鹧
鴣	鸪
擁	拥
綱	纲
擴	扩
攔	拦
攬	揽
𢺳	𪮳	𢺳
穫	获
榜	榜	搒
鷂	鹞
顰	颦
啟	启
稟	禀
敍	敍	叙
敘	叙
誨	诲
潔	洁
飭	饬
驢	驴
紮	紮	扎
蘿	萝
蔔	卜
確	确
嘜	唛
勗	勖	勗
轟	轰
違	违
暢	畅
暫	暂
曨	昽
綫	线	綫
鈺	钰
蹺	跷
遲	迟
蔭	荫
賠	赔
鬎	瘌	鬎
鬁	痢	鬁
癩	癞
薊	蓟
纓	缨
邁	迈
鄭	郑
縛	缚
濤	涛
沈	沉	沈
枴	拐	枴
樑	梁
鏞	镛
潛	潜
紂	纣
驁	骜
馴	驯
蟬	蝉
啓	启	啓
錦	锦
艷	艳
梘	枧
紡	纺
鴛	鸳
鴦	鸯
棖	枨
棗	枣
棡	㭎
楊	杨
榮	荣
譽	誉
銜	衔
榦	干	榦
斂	敛
討	讨
檳	槟
櫻	樱
羨	羡
瞞	瞒
欽	钦
歐	欧
驟	骤
鱔	鳝
禍	祸
殘	残
殞	殒
殭	僵
殮	殓
殯	殡
鐧	锏
殽	淆	肴
毆	殴
嬰	婴
氹	凼	氹
氾	泛
濫	滥
漬	渍
濁	浊
銘	铭
洶	汹
謹	谨
瀋	沈
灕	漓
淒	凄	淒
淥	渌
礪	砺
淵	渊
鬧	闹
艦	舰
渙	涣
渦	涡
燦	灿
渾	浑
湊	凑
滄	沧
滙	汇
滷	卤
繹	绎
漚	沤
潑	泼
澇	涝
澗	涧
澤	泽
澱	淀
濺	溅
濾	滤
瀏	浏
瀕	濒
瀠	潆
餃	饺
燄	焰
鉤	钩
鐮	镰
鑽	钻
燶	㶶
毀	毁
馳	驰
請	请
甚	什	甚
釀	酿
罌	罂
韌	韧
懣	懑
熒	荧
疿	痱
騰	腾
燉	炖	燉
漿	浆
竊	窃
縫	缝
軋	轧
牠	它	牠
牽	牵
瀾	澜
賓	宾
獪	狯
狹	狭
狽	狈
謎	谜
獅	狮
闢	辟
獵	猎
獷	犷
燁	烨
璽	玺
鐲	镯
璫	珰
騮	骝
瓏	珑
瑒	玚
璉	琏
瑣	琐
瑪	玛
璦	瑷
琿	珲
迴	回
甕	瓮
筍	笋
耶	耶	爷
籃	篮
鏽	锈	鏽
繩	绳
癬	癣
憊	惫
歿	殁
纏	缠
瘋	疯
痾	痾	疴
瘀	瘀	淤
癒	愈
癡	痴
癰	痈
癱	瘫
鯧	鲳
隸	隶
誤	误
矇	蒙	矇
睜	睁
瞇	眯
査	查	査
矚	瞩
薳	䓕	薳
矯	矫
硤	硖
碁	棋	碁
鮑	鲍
碩	硕
纖	纤
磾	䃅
禱	祷
祕	秘
魯	鲁
戸	户	戸
樞	枢
蕭	萧
祿	禄
禦	御
禪	禅
籟	籁
稈	秆
隱	隐
楓	枫
遜	逊
贊	赞
鈎	钩
窺	窥
贖	赎
錐	锥
競	竞
籤	签
罷	罢
賬	账
誠	诚
篩	筛
簍	篓
簞	箪
銳	锐
糴	籴
糾	纠
噹	当
鱒	鳟
緋	绯
鸛	鹳
純	纯
錠	锭
鎮	镇
紥	扎
緻	致
膩	腻
絹	绢
綁	绑
綸	纶
緯	纬
綜	综
綢	绸
綵	彩	䌽
綽	绰
綾	绫
緞	缎
綿	绵
緩	缓
緬	缅
練	练
縈	萦
縉	缙
紳	绅
闔	阖
縷	缕
繡	绣
繫	系
纍	累
贅	赘
羈	羁
奐	奂
衆	衆	众
濱	滨
撾	挝
鵬	鹏
齧	啮	齧
桿	杆
穌	稣
聰	聪
診	诊
瘍	疡
襲	袭
註	注
膚	肤
膿	脓
臉	脸
臚	胪
臥	卧	臥
犢	犊
駒	驹
蕪	芜
菢	抱	菢
薘	荙
菸	烟	菸
鹼	碱	硷
蹤	踪
謙	谦
蘊	蕴	蘊
蒔	莳
婁	娄
蔞	蒌
蔣	蒋
蔥	葱
薰	薰	熏
藉	藉	借
鋒	锋
藴	蕴	藴
蘋	苹	𬞟
蘢	茏
蛻	蜕
餡	馅
饊	馓
蜑	蛋	蜑
蝸	蜗
螄	蛳
螢	萤
蠶	蚕
鯨	鲸
軀	躯
閃	闪
衕	同	衕
襤	褴
鈕	钮
複	复
訛	讹
訶	诃
釋	释
詎	讵
詐	诈
諦	谛
詫	诧
姦	奸
諂	谄
諛	谀
鎗	鎗	枪
諢	诨
諱	讳
諷	讽
謁	谒
謄	誊
謗	谤
謠	谣
譁	哗
譏	讥
譖	谮
趙	赵
譚	谭
譯	译
讕	谰
讚	赞
鯪	鲮
豈	岂
豎	竖
豔	艳
玀	猡
頑	顽
貧	贫
賄	贿
贓	赃
貯	贮
飽	饱	飽
貸	贷
賑	赈
賒	赊
賜	赐
賦	赋
賺	赚
贈	赠
閱	阅
頌	颂
贔	赑
鱲	鱲	𫚭
趕	赶
櫳	栊
餵	喂
遙	遥
躍	跃
砲	炮
廂	厢
軑	轪
軫	轸
較	较
輓	挽
飄	飘
輜	辎
輿	舆
轄	辖
轇	𫐖	轇
這	这
貫	贯
遼	辽
晉	晋
鄧	邓
樺	桦
醃	腌
醖	酝	醖
嘯	啸
餌	饵
鈒	钑
鉛	铅
礦	矿
鱈	鳕
銻	锑
鋅	锌
鍍	镀
鍛	锻
鎚	锤
鎢	钨
鏘	锵
鏢	镖
鏨	錾
鏺	䥽
鐃	铙
鈸	钹
鐳	镭
鑌	镔
鑠	铄
钂	镋
籐	藤
閂	闩
閏	闰
閔	闵
騫	骞
閨	闺
閹	阉
闃	阒
礫	砾
闖	闯
鍵	键
騭	骘
嫻	娴
煒	炜
綺	绮
貞	贞
瑩	莹
鄰	邻
攜	携
雖	虽
猶	犹
雛	雏
燙	烫
靂	雳
韃	鞑
韓	韩
韞	韫
韮	韭
頁	页
繳	缴
頒	颁
頰	颊
頹	颓
顒	颙
颶	飓
餬	糊
飢	饥
鴆	鸩
燻	熏
餛	馄
飩	饨
飼	饲
餿	馊
饉	馑
饒	饶
濃	浓
檻	槛
馮	冯
駐	驻
駟	驷
駢	骈
騸	骟
驍	骁
訝	讶
驛	驿
驥	骥
龕	龛
痺	痹	痺
髏	髅
髪	发	髪
鬩	阋
倆	俩
鰓	鳃
鯇	鲩
鯉	鲤
鯛	鲷
鯢	鲵
鯿	鳊
鰂	鲗
鰥	鳏
鰨	鳎
鱗	鳞
鱟	鲎
嗚	呜
鵂	鸺
鵠	鹄
鵃	鸼
鵪	鹌
鶉	鹑
鵰	雕
鵲	鹊
鶻	鹘
鶼	鹣
鰈	鲽
鷺	鹭
鷥	鸶
鸚	鹦
鸞	鸾
鹵	卤
梟	枭
霑	沾
驊	骅
綴	缀
黴	霉
譟	噪
齙	龅
齠	龆
繃	绷
㑳	㑇
㑺	俊
㒺	罔
㓂	寇
㕁	却
㕑	厨
㕥	㕥	以
㘭	坳
㝛	宿
㝠	冥
㝡	最
㞞	𪨊
㟁	岸
㠀	岛
㠯	以
㠶	帆
㡌	帽
㢘	廉
㢠	迥
㤙	恩
㥦	惬
㧱	拿
㨗	捷
㨪	晃
㨿	据
㩗	携
㩜	㨫
㩦	携
㪚	散
㪟	敦
㬉	暖
㯭	橹
㱃	饮
㳄	涎
㳒	法
㴱	深
㵎	涧
㼝	碗
㽞	留
㿜	瘪
䈰	筲
䊀	糊
䗬	蜂
䘏	恤
䘑	脉
䘚	卒
䛐	词
䝔	獾
䠀	䠀	趟
䠶	射
䥑	鿏
䥥	镰
䬃	飒
䭾	驮
䰟	魂
䰾	鲃
䳘	鹅
䴉	鹮
鷸	鹬
䴸	麸
䶊	衄
鍋	锅
貶	贬
頃	顷
鑰	钥
轍	辙
螞	蚂
趨	趋
瞭	瞭	了
顆	颗
鬨	哄
艱	艰
韙	韪
葷	荤
鰻	鳗
屜	屉
壩	坝
鷗	鸥
鵐	鹀
瞼	睑
蒼	苍
傚	效
頜	颌
頷	颔
齦	龈
頦	颏
獄	狱
詔	诏
錨	锚
匱	匮
輊	轾
慄	栗
況	况
脛	胫
饅	馒
諳	谙
貲	赀
輟	辍
鉞	钺
銹	锈
氫	氢
蠑	蝾
壢	坜
嶽	岳
鵑	鹃
鶲	鹟
鶯	莺
擱	搁
曠	旷
乹	乾	干
噦	哕
癟	瘪
餾	馏
亁	乾	干
竄	窜
噁	恶	𫫇
鈦	钛
鈾	铀
錳	锰
鈉	钠
諉	诿
繽	缤
釩	钒
癆	痨
陘	陉
亙	亘
亝	亝	斋
鵡	鹉
綬	绶
彙	汇
滬	沪
菴	菴	庵
鋥	锃
亯	享
亱	夜
亷	廉
亾	亡
訖	讫
鶇	鸫
瓊	琼
閫	阃
馭	驭
眥	眦
饗	飨
儷	俪
犧	牺
謨	谟
伕	伕	夫
茲	兹	茲
侶	侣
佀	似
佇	伫
盧	卢
窪	洼
齲	龋
貳	贰
鏵	铧
繭	茧
踐	践
餚	肴
鈷	钴
侷	局
箋	笺
俁	俣
俔	伣
諺	谚
俛	俛	俯
鑣	镳
繕	缮
俲	效
俻	备
倀	伥
廩	廪
鴞	鸮
倐	倏
儻	傥
澆	浇
倣	仿
傯	偬
倸	睬
頗	颇
偘	侃
緝	缉
偺	咱
傌	㐷
誦	诵
篋	箧
儸	㑩
僉	佥
僊	仙
麽	么	麽
僞	伪
僤	𫢸
僥	侥
僨	偾
隴	陇
儁	俊
儂	侬
儈	侩
儎	傤
儐	傧
儔	俦
儗	拟
儘	尽
儵	倏
儺	傩
鷲	鹫
勳	勋
彞	彝
槃	槃	盘
霽	霁
懞	蒙	懞
兌	兑
兎	兔
兗	兖
兠	兜
訌	讧
煥	焕
殲	歼
棲	栖
噸	吨
畝	亩
韜	韬
軛	轭
鑄	铸
冄	冉
冐	冒
冣	冣	最
誣	诬
蟄	蛰
磧	碛
鑹	镩
颼	飕
冺	泯
濛	蒙
凢	凡
凴	凭
櫱	蘖
訟	讼
槳	桨
幟	帜
刦	劫
刧	劫
莧	苋
蝟	猬
鶩	鹜
刼	劫
剄	刭
剉	锉
剋	克
翹	翘
剏	创
剗	刬
剙	创
訥	讷
纔	才
剮	剐
剳	剳	札
剴	剀
剹	戮
鶚	鹗
劊	刽
劌	刿
鶥	鹛
鴴	鸻
劒	剑
簣	篑
磯	矶
劵	券	劵
勅	敕
勌	倦
勑	敕
輒	辄
餒	馁
勠	戮
勣	𪟝
勦	剿
勩	勚
勱	劢
勲	勋
誡	诫
匃	丐
匄	丐
閥	阀
鴝	鸲
鷚	鹨
匟	炕
匭	匦
攏	拢
匲	奁
匳	奁
齷	龌
齪	龊
潯	浔
譙	谯
贍	赡
轅	辕
鰲	鳌
駱	骆
襖	袄
鸝	鹂
簾	帘
鵜	鹈
鶘	鹕
卹	恤
厀	膝
厙	厍
葦	苇
諒	谅
厤	历
橢	椭
叅	参
芻	刍
詰	诘
諜	谍
饋	馈
締	缔
叚	假
叡	睿
硯	砚
箏	筝
縴	纤
藺	蔺
驪	骊
嚀	咛
滲	渗
幀	帧
巹	卺
滌	涤
襠	裆
愾	忾
諮	谘
韁	缰
邇	迩
吚	咿
嗇	啬
嚥	咽
雋	隽
燐	燐	磷
鈣	钙
簫	箫
閭	闾
韋	韦
呌	叫
呪	咒
嗶	哔
囁	嗫
譴	谴
咊	和
闐	阗
詛	诅
噠	哒
噥	哝
嚙	啮
咲	笑
嗆	呛
咷	啕
咼	呙
慟	恸
哶	咩
唄	呗
肅	肃
唕	唣
唘	啓
唚	吣
唫	吟	唫
飆	飙
啑	喋
啗	啖
啢	唡
啣	衔
囀	啭
崑	昆
喆	哲	喆
喒	咱
鵟	鵟	𫛭
樅	枞
皰	疱
鉻	铬
嗁	啼
嗊	唝
詬	诟
嗩	唢
嘊	啀
嘑	呼
嘓	啯
嘠	嘎
謔	谑
饞	馋
嘵	哓
嘷	嗥
嘽	啴
噘	噘	撅
噝	咝
噯	嗳
噲	哙
嚌	哜
囌	苏
嚦	呖
嚮	向
嚲	亸
嚳	喾
嚶	嘤
囅	冁
囈	呓
囓	啮
囙	因
錮	锢
懟	怼
紇	纥
鑾	銮
囪	囱
圇	囵
圅	函
鯡	鲱
窯	窑
鱉	鳖
祇	祇	只
堝	埚
坵	丘
坿	附
垜	垛
埜	野
埡	垭
埳	坎
紼	绋
樁	桩
廡	庑
堃	坤	堃
堊	垩
堖	垴
堘	塍
堦	阶
塋	茔
塏	垲
塒	埘
塚	冢
繆	缪
塟	葬
塢	坞
塤	埙
塲	场
蟎	螨
塼	砖
塿	𪣻
墖	塔
墠	𫮃
墪	墩
櫥	橱
壄	野
壋	垱
壙	圹
壚	垆
壠	垅
壻	婿
夘	卯
袞	衮
戧	戗
魘	魇
嶼	屿
鶺	鹡
鴒	鸰
鯊	鲨
鵯	鹎
鮃	鲆
燴	烩
鴇	鸨
鶪	䴗
螻	蝼
蠍	蝎
詭	诡
譎	谲
訢	䜣
詝	詝	𬣞
奩	奁
媧	娲
奼	姹
騖	骛
嬪	嫔
嬈	娆
妬	妒
妳	你	奶	妳
妷	侄
姉	姊
姍	姗
姙	妊
懾	慑
駭	骇
娿	婀
婣	姻
谿	溪
媍	妇
媯	妫
媼	媪
媿	愧
嫗	妪
嫰	嫩
嫵	妩
嫺	娴
嫿	婳
嬀	妫
嬃	媭
嬋	婵
嬙	嫱
嬝	袅
嬤	嬷
嬭	奶
嬾	懒
孃	娘
孌	娈
軻	轲
臏	膑
孼	孽
宁	㝉
宂	冗
謐	谧
讞	谳
駿	骏
宼	寇
寃	冤
寑	寝
磣	碜
寕	宁
陝	陕
寳	宝
尅	克
絀	绌
繚	缭
疇	畴
釁	衅
覷	觑
髒	脏
鷦	鹪
鷿	䴙
鷈	䴘
尒	尔
鱸	鲈
尟	鲜
尠	鲜
尷	尴
釦	扣
鰭	鳍
屓	屃
屨	屦
屭	屃
鉀	钾
巔	巅
櫸	榉
岅	坂
鞏	巩
嵐	岚
峝	峒
峩	峨
峴	岘
禎	祯
崍	崃
嶇	岖
崐	昆
顥	颢
崘	仑
崬	岽
嵒	岩
嵗	岁
嶁	嵝
嶃	崭
嶔	嵚
嶗	崂
嶠	峤
嶢	峣
嶧	峄
嶨	峃
嶮	崄
嶴	岙
巗	岩
巘	𪩘	巘
鳾	䴓
覡	觋
巰	巯
巵	卮
帀	匝
鯽	鲫
帋	纸
帬	裙
幃	帏
幇	帮
幑	徽
幘	帻
幙	幕
幚	帮
幬	帱
庻	庶
庽	寓
廄	厩
廎	庼	廎
廐	厩
廕	荫
廞	𫷷
廵	巡
廹	迫
甌	瓯
鄴	邺
廼	乃
弒	弑
弳	弪
燾	焘
彄	𫸩
彆	别
彊	强
彠	彟
貽	贻
繪	绘
癉	瘅
彷	仿	彷
彿	佛
徃	往
畬	畲
鉉	铉
徧	遍
漸	渐
顫	颤
憚	惮
怱	匆
怳	恍
恠	怪
恡	吝
悞	悮
悤	匆
愴	怆
悳	德
悵	怅
惏	婪	惏
瘧	疟
惥	恿
惪	德
惲	恽
惷	蠢
愙	恪
愜	惬
愨	悫
愬	诉
愷	恺
愽	博
慂	恿
靄	霭
慍	愠
慙	惭
慤	悫
慪	怄
慫	怂
慴	慑
慼	戚
慽	戚
憇	憩
軾	轼
憒	愦
憖	慭
憮	怃
懃	勤
懌	怿
懍	懔
懨	恹
懺	忏
懽	欢
戔	戋
戞	戛
戩	戬
戯	戏
戹	厄
戼	卯
鍬	锹
銬	铐
賚	赉
鑔	镲
扞	捍
綏	绥
鬮	阄
繯	缳
縊	缢
擻	擞
抝	拗
躥	蹿
鉚	铆
拏	拿
拕	拖
攢	攒
謫	谪
蹻	跷
聵	聩
挱	挲
挵	弄
捄	救
捫	扪
掄	抡
擧	举
闡	阐
掽	碰
揑	捏
櫫	橥
揷	插
搆	构
搇	揿
櫓	橹
搤	扼
搥	捶
褳	裢
訕	讪
搯	掏
搾	榨
摀	捂	摀
摃	扛
摜	掼
摶	抟
摻	掺
撏	挦
撝	㧑
撡	操
撣	掸
撦	扯
撿	捡
擄	掳
瑯	琅
鋃	锒
擕	携
擡	擡	抬
擯	摈
擼	撸
擽	㧰
攄	摅
攆	撵
攖	撄
攙	搀
攛	撺
攩	挡
轡	辔
軼	轶
攷	考
訐	讦
敂	叩
敓	敚
柵	栅
敭	扬
敱	敳
敺	驱
牘	牍
縐	绉
謅	诌
斕	斓
鷯	鹩
鶹	鹠
駮	驳
鱧	鳢
絳	绛
斲	斫
斵	斫
旂	旗
旤	祸
獺	獭
旹	时
熾	炽
旾	春
礬	矾
昚	慎
昬	昏
昰	是
晛	𬀪
晟	晟	成
鸕	鸬
鶿	鹚
晳	晰
顗	顗	𫖮
晻	暗
暎	映
暐	𬀩
暘	旸
暠	暠	皓
暱	昵
鸌	鹱
曄	晔
曇	昙
曏	向
曖	暧
曡	叠
錕	锟
誇	夸
絛	绦
覲	觐
朞	期
朢	望
朧	胧
朮	朮	术
鎔	镕
朶	朵
隉	陧
釗	钊
肈	肇
贄	贽
脩	脩	修
枏	楠
紓	纾
藪	薮
椏	桠
櫞	橼
櫟	栎
柟	楠
柹	柿
栁	柳
鳶	鸢
栞	刊
栢	柏
栰	筏
鎂	镁
桒	桑
欏	椤
桮	杯
桺	柳
梔	栀
梜	𬂩	梜
鳧	凫
棊	棋
櫚	榈
棶	梾
槨	椁
椀	碗
椉	乘
椶	棕
椷	缄
椾	笺
楄	匾
楥	楦
楨	桢
楳	梅
榘	矩	榘
榪	杩
榲	榅
槤	梿
榿	桤
槀	槁
槑	梅
槕	桌
槧	椠
槩	概
槮	椮
槼	规
樐	橹
猻	狲
橈	桡
橜	橛
輛	辆
橤	蕊
檁	檩
檉	柽
檜	桧
檝	楫
檟	槚
檣	樯
檮	梼
櫂	棹
櫛	栉
櫝	椟
櫧	槠
櫨	栌
櫪	枥
櫬	榇
櫺	棂
欒	栾
欝	郁
欞	棂
歟	欤
詮	诠
鑲	镶
蹣	蹒
陞	升
歴	历
殀	夭
殨	㱮
殫	殚
殰	㱩
毘	毗
毿	毵
氂	牦
氊	毡
氌	氇
痙	痉
氳	氲
鋁	铝
烴	烃
氬	氩
銨	铵
滸	浒
氷	冰
汎	泛
浹	浃
汚	污
蘺	蓠
穢	秽
衊	蔑
隄	堤
湼	涅
淪	沦
饃	馍
濘	泞
蘚	藓
鰍	鳅
銖	铢
涇	泾
贛	赣
蠣	蛎
涖	莅
鮒	鲋
漣	涟
淛	浙
淩	淩	凌
褻	亵
詣	诣
淶	涞
渢	沨
湞	浈
湻	淳
溈	沩
溮	浉
溳	涢
溼	湿
滎	荥
滛	淫
滻	浐
漊	溇	漊
漵	溆
潁	颍
潄	漱
潷	滗
潿	涠
澁	涩
澂	澄
澠	渑
澣	浣
澦	滪
澫	𬇕	澫
澮	浍
鱺	鲡
濜	浕
觴	觞
濬	浚
濰	潍
濶	阔
濼	泺
瀅	滢
瀆	渎
瀘	泸
瀦	潴
瀧	泷
瀰	弥
瀲	潋
灃	沣
灄	滠
灋	法
灝	灏
灤	滦
灨	赣
灩	滟
燼	烬
炤	炤	照
釺	钎
燬	毁
烖	灾
烱	炯
飪	饪
煑	煮
煖	暖
煗	暖
礆	硷
煢	茕
煬	炀
熈	熙
羆	罴
熗	炝
爍	烁
熰	𬉼	熰
熲	颎
燀	𬊤	燀
燖	𬊈
燜	焖
爕	燮
爗	烨
縵	缦
爿	丬	爿
牋	笺
牎	窗
牐	闸
牓	榜
牕	窗
絆	绊
犇	奔
犖	荦
睏	困
狥	徇
猂	悍
猙	狰
獰	狞
獁	犸
猨	猿
獃	獃	呆
獋	嗥
獘	毙
獧	狷
獫	猃
獮	狝
獱	㺍
獼	猕
玅	妙
糝	糁
瓅	𬍛	瓅
玨	珏
饈	馐
饌	馔
珎	珍
珮	佩
隕	陨
琊	玡
琍	璃
琹	琴
琺	珐
瑇	玳
瑋	玮
瑠	琉
瑲	玱
璊	𫞩	璊
璡	琎
璢	琉
璯	㻅
璵	玙
璿	璇
瓈	璃
瓌	瑰
瓔	璎
瓚	瓒
臍	脐
甎	砖
甖	罂
迺	迺	乃
鉅	巨	钜
甞	尝
糰	团
甯	宁
鎧	铠
畂	亩
畆	亩
畊	耕
畧	略
畮	亩
蕁	荨
畱	留
疉	叠
疎	疏
疘	肛
痐	蛔
瘂	痖
瘓	痪
瘲	疭
瘞	瘗
瘮	瘆
癧	疬
癘	疠
瘻	瘘
癄	憔
癅	瘤
癇	痫
癈	废
癤	疖
癥	症
癭	瘿
紺	绀
軔	轫
鸏	鹲
皙	皙	晰
蘞	蔹
鑞	镴
皚	皑
鱀	𬶨	暨
鷳	鹇
莢	荚
鎛	镈
皐	皋
硃	朱
皜	皓
綻	绽
皷	鼓
皸	皲
盇	盍
盌	碗
睞	睐
眎	视
眡	视
紜	纭
睍	𪾢
睠	眷
睪	睪	睾
瞖	翳
瞘	眍
瞜	䁖
闍	阇
矁	瞅
矓	眬
矙	瞰
矴	碇
砦	寨
鎵	镓
硜	硁
硨	砗
鋇	钡
碪	砧
碭	砀
碸	砜
礡	礴
磑	硙
磟	碌
磽	硗
礄	硚
礐	𬒈	礐
礱	砻
臠	脔
禑	祦
禕	祎
禩	祀
禰	祢
秊	年
秌	秋
秔	粳
秖	只
賃	赁
稉	粳
稬	糯
稭	秸
稺	稚
穡	穑
顙	颡
稾	稿
穅	糠
穇	䅟	穇
穉	稚
穤	糯
穨	颓
穭	穞
穽	阱
窓	窗
黷	黩
窵	窎
窶	窭
窻	窗
竚	伫
竝	并
竢	俟
竪	竖
鮫	鲛
靨	靥
籙	箓
筞	策
筦	筦	管
筧	笕
筩	筒
筯	箸
筴	策
讌	宴	䜩
箇	个
箒	帚
箠	棰
鏃	镞
篔	筼
簹	筜
篢	𬕂	篢
篳	筚
篹	篹	纂
簀	箦
簑	蓑
簒	篡
簮	簪
籑	籑	馔
籔	䉤
籖	签
籛	篯
籜	箨
籢	奁
籩	笾
籪	簖
麴	曲	麴
粃	秕
粇	糠
糲	粝
粦	磷
粺	稗
糉	粽
糶	粜
糺	糺	纠
紃	𬘓	紃
鰹	鲣
紆	纡
紈	纨
絝	绔
紉	纫
閩	闽
紕	纰
紘	纮
紝	纴
紞	𬘘
紬	䌷
紱	绂
紲	绁
紵	纻
紿	绐
絅	䌹
絎	绗
絏	绁
縭	缡
絢	绚
絪	𬘡
絰	绖
絶	绝
絺	𫄨	絺
綃	绡
綆	绠
綈	绨
綉	绣
綌	绤
綑	捆
綖	𫄧
綝	𬘭
綣	绻
綪	𬘬	綪
綯	绹
綰	绾
綳	绷
綹	绺
緄	绲
緇	缁
緐	繁
緑	緑	绿
緔	绱
緗	缃
緜	绵
緡	缗
緥	褓
緦	缌
緱	缑
緲	缈
緶	缏
緹	缇
縋	缒
縑	缣
縕	缊
縗	缞
縝	缜
縞	缟
縟	缛
縧	绦
縯	𬙂	縯
騁	骋
縲	缧
縳	䌸
縶	絷
縹	缥
繅	缫
繒	缯
繖	伞
繢	缋
繦	襁
繮	缰
繰	缲
繸	䍁
繾	缱
纁	𫄸	纁
纆	𬙊	纆
纇	颣
纊	纩
纕	𬙋
纘	缵
缾	瓶
罇	樽
罈	坛
罋	瓮
鍰	锾
罸	罚
羋	芈
鴕	鸵
羗	羌
羥	羟
羴	膻
鮐	鲐
翄	翅
翦	翦	剪
躚	跹
翫	玩
翬	翚
翺	翱
翽	翙
鴰	鸹
鍁	锨
耑	专	端
耬	耧
鬢	鬓
聹	聍
聶	聂
閾	阈
肎	肯
肐	胳
肧	胚
銓	铨
胷	胸
脃	脆
脇	胁
脗	吻
臢	臜
腖	胨
腡	脶
誹	诽
膃	腽
膓	肠
膕	腘
膾	脍
臈	腊
臋	臀
臕	膘
臙	胭
臝	裸
詡	诩
臯	皋
鰟	鳑
鮍	鲏
舘	馆
舩	船
艢	樯
艣	橹
艤	舣
艪	橹
艫	舻
艶	艳
艸	草
鰱	鲢
芲	花
蕘	荛
蕒	荬
苧	苎
鎊	镑
茘	荔
荍	荞
薺	荠
菑	灾	菑
菓	果
菕	芲
轂	毂
鎣	蓥
萇	苌
萲	萱
萵	莴
葒	荭
葠	参
葯	药
蒓	莼
蒞	莅
蓀	荪
蓡	参
蓽	荜
蓯	苁
蓴	莼
蔆	菱
蔕	蒂
鍔	锷
蔦	茑
蕆	蒇
蕋	蕊
蕓	芸
蕕	莸
蕚	萼
蕢	蒉
蕷	蓣
蕿	萱
薀	蕰
薈	荟
薌	芗
薔	蔷
薙	剃
諤	谔
釵	钗
藎	荩
藶	苈
藷	薯
藼	萱
蘀	萚
蘂	蕊
蘄	蕲
蘐	萱
蘓	苏
蘤	花
虉	𬟁	虉
虯	虬
虵	蛇
蚘	蛔
蛕	蛔
蛺	蛱
蜋	螂
蜖	蛔
餞	饯
蜨	蝶
蜺	霓
蝀	𬟽	蝀
鱝	鲼
蝡	蠕
蝯	猿
蝱	虻
螎	融
螡	蚊
螮	䗖
螿	螀
蟁	蚊
蟇	蟆
蟈	蝈
蟣	虮
蟯	蛲
蟶	蛏
鴷	䴕
蠆	虿
蠏	蟹
蠐	蛴
蠒	茧
蠨	蟏
蠭	蜂
衂	衄
衇	脉
衖	弄	衖
衘	衔
衚	胡
衹	只	衹
衺	邪
袠	帙
袴	裤	袴
袵	衽
裊	袅
裌	夹
裠	裙
裵	裴
褌	裈
褘	袆
褭	袅
襃	褒
襇	裥
襍	杂
襏	袯
襝	裣
襢	袒	襢
襬	摆	䙓
襴	襕
覇	霸
覈	核
覊	羁
閻	阎
覎	觃
覔	觅
覘	觇
覥	觍
覦	觎
覩	睹
覬	觊
覯	觏
覿	觌
觕	粗
觶	觯
賅	赅
訁	讠
訃	讣
訏	𬣙
訒	讱
詁	诂
証	证
詆	诋
詒	诒
詖	诐
詗	诇
詘	诎
詧	察
詵	诜
詶	酬
詼	诙
詿	诖
誄	诔
誆	诓
誑	诳
誒	诶
誖	悖
誚	诮
誥	诰
誶	谇
誾	訚
諍	诤
諏	诹
諐	愆
諑	诼
諙	话
諝	谞
諞	谝
諟	𬤊
諠	喧
諡	谥
諴	𫍯
諶	谌
諼	谖
謌	歌
謏	𫍲	謏
謖	谡
謚	谥
謩	谟
謭	谫
謳	讴
謾	谩
譆	嘻
譌	讹
譔	撰
譞	𫍽	譞
譫	谵
譭	毁
譸	诪
讁	谪
讃	赞
讅	谉
讋	詟
讎	雠
讒	谗
讖	谶
讙	欢
讜	谠
豓	艳
豶	豮
貍	狸
貎	猊
貙	䝙
貛	獾
貟	贠
饜	餍
貰	贳
貺	贶
賁	贲
賂	赂
賉	恤
賕	赇
賙	赒
賛	赞
賡	赓
賧	赕
賫	赍
鬭	斗
賵	赗
賷	赍
賻	赙
賾	赜
贇	赟
贋	赝
贐	赆
贑	赣
贗	赝
贜	赃
赬	赪
趂	趁
躓	踬
蹌	跄
跥	跺
跴	踩
踁	胫
躕	蹰
踫	碰
踰	逾
踴	踊
躪	躏
蹏	蹄
蹔	暂
蹕	跸
躂	跶
蹵	蹴
躊	踌
躋	跻
躑	踯
躒	跞
躡	蹑
躦	躜
躭	耽
躳	躬
躶	裸
輥	辊
軏	𫐄
軝	𬨂
齶	腭
軹	轵
軺	轺
輦	辇
輅	辂
輇	辁
輈	辀
輋	𪨶
輗	𫐐
輙	辄
輞	辋
輬	辌
輭	软
輮	𫐓	輮
輳	辏
輶	𬨎	輶
輾	辗
轀	辒
轤	轳
轔	辚
轢	轹
辠	罪
辢	辣
辤	辞
辳	农
邐	逦
逈	迥
逕	径	迳
逥	回
逩	奔
遉	侦
遡	溯
遯	遁
遶	绕
鄲	郸
郟	郏
鄆	郓
鄒	邹
鄔	邬
鄖	郧
鄩	𬩽
鄶	郐
鄺	邝
酇	酂
酈	郦
酧	酬
醕	醇
醞	酝
醱	酦
醲	𬪩
醻	酬
醼	宴
釃	酾
釅	酽
鎦	镏
閶	阊
釓	钆
釔	钇
釕	钌
銱	铞
鈀	钯
釙	钋
鼴	鼹
釤	钐
釧	钏
釬	焊
釷	钍
釹	钕
鈁	钫
鈃	钘
鈄	钭
鈆	鈆	铅
鈇	𫓧
鈈	钚
鈐	钤
鈑	钣
鈥	钬
鈧	钪
鈮	铌
鈰	铈
鈳	钶
鐺	铛
鉧	𬭁	鉧
鈹	铍
鈽	钸
鈿	钿
鉈	铊
鉊	𬬿
鉋	铇
鉍	铋
鉑	铂
鉕	钷
鉝	𫟷
鉥	𬬸
鉦	钲
鉬	钼
鉭	钽
鉶	铏	鉶
鉺	铒
鉿	铪
銍	铚
銑	铣
鏤	镂
銚	铫
銛	铦
銠	铑
銣	铷
銥	铱
銦	铟
銩	铥
銪	铕
銫	铯
銲	焊
銼	锉
銾	汞
鋌	铤
鋏	铗
鋐	𬭎
鋩	铓
鋙	铻
鋝	锊
鋟	锓
鋦	锔
鋨	锇
鋮	铖
鋯	锆
鋰	锂
鋱	铽
鋹	𬬮
鋻	鉴
鏰	镚
鐱	钎	鐱
錀	𬬭
錁	锞
錆	锖
錇	锫
錈	锩
錏	铔
錒	锕
錙	锱
錚	铮
錛	锛
錞	𬭚	錞
錟	锬
錡	锜
錤	𫓹
錩	锠
錸	铼
鍀	锝
鍆	钔
鍇	锴
鍈	锳
鍘	铡
鍚	钖
鍠	锽
鍤	锸
鍥	锲
鍩	锘
鍫	锹
鍭	𬭤
鍳	鉴
鍶	锶
鍺	锗
鍼	针
鎄	锿
鎇	镅
鎌	镰
鎓	𬭩
鎘	镉
鎡	镃
鎩	铩
鎪	锼
鎰	镒
鎲	镋
鎳	镍
鎻	锁
鎿	镎
鏇	镟	旋
鏌	镆
鏐	镠
鏑	镝
鏗	铿
鏜	镗
鏝	镘
鏷	镤
鏹	镪
鏻	𬭸
鐇	𫔍
鐒	铹
鐓	镦
鐔	镡
鐙	镫
鐝	镢
鐠	镨
鐦	锎
鐨	镄
鐩	𬭼
鐫	镌
鐶	镮
鐽	𫟼	鐽
鐿	镱
鑕	锧
鑚	钻
鑛	矿
鑤	刨
鑥	镥
鑪	炉	𬬻
鑭	镧
鑱	镵
鑵	罐
鑷	镊
钁	䦆	镢
閆	闫
閈	闬
閌	闶
閎	闳
閙	闹
閡	阂
閤	合	閤
閧	哄
閬	阆
閼	阏
閽	阍
閿	阌
闇	暗
闉	𬮱
闋	阕
闑	𫔶
闒	阘
闓	闿
闚	窥
闞	阚
闠	阓
闤	阛
阬	坑
陗	峭
鷙	鸷
陻	堙
陿	狭
隂	阴
隖	坞
隣	邻
隤	𬯎
隮	𬯀
顴	颧
隷	隶
雝	雍
靆	叇
靉	叆
靝	靔
靦	腼	䩄
靭	韧
靱	韧
鞌	鞍
鞵	鞋
鞾	靴
韈	袜
韉	鞯
馱	驮
韍	韨
韤	袜
颳	刮
頇	顸
頊	顼
頍	𫠆
頎	颀
頏	颃
頔	𬱖	頔
頟	额
頠	𬱟
頫	𫖯
頲	颋
頴	颕
頼	赖
頽	颓
顇	悴
顋	腮
顓	颛
顔	颜
顢	颟
顦	憔
顬	颥
顳	颞
颭	飐
颮	飑
颱	台
颸	飔
颺	飏
颻	飖
颿	帆
飀	飗
飃	飘
飈	飚
飜	翻
飠	饣
飣	饤
飤	饲
飥	饦
飫	饫
飱	飧
餁	饪
餄	饸
餎	饹
餑	饽
餔	哺
餕	馂
餖	饾
餗	𫗧
餜	馃
餧	喂
餱	糇
餳	饧
餹	糖
餺	馎
餻	糕
餼	饩
餽	馈
饁	馌
饍	膳
饘	𫗴
饝	馍
饟	饷
饢	馕
馹	驲
馿	驴
駃	𫘝	駃
駈	驱
駉	𬳶
駑	驽
駓	𬳵
駔	驵
駘	骀
駙	驸
駞	驼
駡	骂
駪	𬳽
駰	骃
駸	骎
騂	骍
騄	𫘧
騅	骓
騌	骔
騍	骒
騏	骐
驎	麟	𬴊
騐	验
騠	𫘨	騠
騣	鬃
騤	骙
騧	䯄
驤	骧
騵	𫘪
騶	驺
驀	蓦
驂	骖
驃	骠
驄	骢
驌	骕
驦	骦
驏	骣
驘	骡
驩	欢
驫	骉
骯	肮
骽	腿
髈	膀
髐	髇
髕	髌
髖	髋
髥	髯
髴	佛
鬀	剃
鬉	鬃
鬦	斗
鬪	斗
鬰	郁
魎	魉
鰾	鳔
魛	鱽
魨	鲀
魴	鲂
鮀	𬶍
鮁	鲅
鮆	𫚖	鮆
鮌	鲧
鮎	鲇
鮚	鲒
鮜	鲘
鮞	鲕
鮟	𩽾	鮟
鱇	𩾌	鱇
鮠	𬶏	鮠
鮣	䲟
鮦	鲖
鮪	鲔
鮭	鲑
鮶	鲪
鮺	鲝
鯀	鲧
鯔	鲻
鯕	鲯
鯖	鲭
鯗	鲞
鯤	鲲
鯫	鲰
鯰	鲇	鲶
鯷	鳀
鰆	䲠
鰉	鳇
鰐	鳄
鰒	鳆
鰜	鳒
鰣	鲥
鰤	𫚕
鰩	鳐
鰮	鳁
鰳	鳓
鰶	𬶭
鰷	鲦
鰺	鲹
鰼	鳛
鱅	鳙
鱓	鳝
鱖	鳜
鱘	鲟
鱠	鲙
鱣	鳣
鱨	鲿
鱭	鲚
鱯	鳠
鱻	鲜
鳬	凫
鳲	鸤
鴈	雁
鵒	鹆
鴯	鸸
鶓	鹋
鵁	䴔
鵓	鹁
鵞	鹅
鵶	鸦
鵷	鹓
鵾	鹍
鶊	鹒
鶖	鹙
鶡	鹖
鶬	鸧
鶱	𬸣	鶱
鷀	鹚
鷁	鹢
鷉	䴘
鷊	鹝
鷖	鹥
鷟	𬸦
鷫	鹔
鸘	鹴
鷭	𬸪
鷰	燕
鷴	鹇
鷽	鸴
鸂	㶉
鸇	鹯
鸊	䴙
鸎	莺
鸑	𬸚
鹺	鹾
鹻	碱
麐	麟
麞	獐
麤	粗
麯	曲	麯
黌	黉
黲	黪
黶	黡
黽	黾
黿	鼋
鼃	蛙
鼇	鳌
鼈	鳖
鼉	鼍
鼕	冬
齎	赍
齏	齑
齔	龀
齕	龁
齗	龂
齜	龇
齟	龃
齬	龉
齣	出
齩	咬
齮	𬺈
齯	𫠜
龎	厐
龑	䶮
龔	龚
龢	和
𨧀	𬭊
𨨏	𬭛
𨭆	𬭶
𨭎	𬭳
撢	掸
軤	轷
壎	埙
羶	膻
鰵	鳘
麅	狍
叄	叁
椹	葚
祂	他
枱	台
灧	滟
